1553989830018641920,vetlanprogramer,2022-08-01 06:23:41+00:00,Railsなんてやっても東京の一部の地域でしか仕事に就けない。しかも高いレベルを要求される。正社員でも給料は安い。やめておいがほういい。Java C# Pythonがいい　求人は全国にあるし　給料も高い 34   #駆け出しエンジニアと繋がりたい,10,1,167,0,https://twitter.com/vetlanprogramer/status/1553989830018641920,11
1553972019028316160,hachi_python,2022-08-01 05:12:55+00:00,サイト監視案件のサイトについて調べることサイトのロボット対策は厳しくないか？無限スクロールになっていないか？これらの答えに全てYesなら3万Noなら5万以上にしないと赤字確定です#駆け出しエンジニアと繋がりたい#プログラミング初心者,12,0,830,129,https://twitter.com/hachi_python/status/1553972019028316160,12
1553970008270991360,UTAChem_OB_PRSK,2022-08-01 05:04:55+00:00,SQLite使うとPythonでSQLがお手軽に使えるけど、個人的にBigQueryとかAWS RedShiftの方がいいなとは思った🙃#今日の積み上げ  #駆け出しエンジニアと繋がりたい#勉強垢さんと繋がりたい#アニメ好きな人と繋がりたい https://t.co/Ac3DoYjqxB,18,0,239,154,https://twitter.com/UTAChem_OB_PRSK/status/1553970008270991360,18
1553963557020221442,TakabotGo,2022-08-01 04:39:17+00:00,【未経験】テックアカデミーのPythonコースで挫折せずに習得できた理由とは？ https://t.co/9wJu8yvM2H #駆け出しエンジニアと繋がりたい#プログラミング初心者#プログラミングスクール,15,0,173,123,https://twitter.com/TakabotGo/status/1553963557020221442,15
1553961224244645888,y__hayashi,2022-08-01 04:30:01+00:00,初心者の方はこれを使うと、すぐに勉強の環境が手に入ります https://t.co/ucQNXnOUmk#buildree #php #Laravel #fuelphp #フレームワーク #apache #nginx #エンジニア #python #go #nodejs #プログラミング学習 #プログラミング初心者,11,1,174,70,https://twitter.com/y__hayashi/status/1553961224244645888,12
1553954269966917633,Inopy6,2022-08-01 04:02:23+00:00,Raspberry Pi＊(Scratch＋Python)＝「」: Today’s Engilsh #032『できることなら・・・してほしいんですが・・・』 https://t.co/EG4t8vaSyI #プログラミング #プログラミング初心者 #プログラミング独学 #駆け出しエンジニアと繋がりたい #英語学習 #英語の勉強,13,0,51,81,https://twitter.com/Inopy6/status/1553954269966917633,13
1553953244119830528,Inopy6,2022-08-01 03:58:19+00:00,Raspberry Pi＊(Scratch＋Python)＝「」: Today’s English #031『Why not』断る理由がない！！ https://t.co/2t6ZBoHcZf #プログラミング #プログラミング初心者 #プログラミング独学 #駆け出しエンジニアと繋がりたい #英語学習 #英語の勉強,17,0,51,81,https://twitter.com/Inopy6/status/1553953244119830528,17
1553940255321227264,sBu5JmF34Xhe2aM,2022-08-01 03:06:42+00:00,#今日の目標勉強する　先週のダメージがでかいので、法令を見るかGitにて構成・コードの続き見る#医療事務 #python #駆け出しエンジニアと繋がりたい#プログラミング初心者と繋がりたい #coding #programming #pythonlearning,20,1,56,21,https://twitter.com/sBu5JmF34Xhe2aM/status/1553940255321227264,21
1553938575019765760,suzuki_py,2022-08-01 03:00:01+00:00,Qiitaで初心者向けの投稿を定期的に漁ってます！#プログラミング#プログラミング初心者#駆け出しエンジニアと繋がりたい40代プログラミング初心者がpython始めて半年！独学で勉強が続いている理由と読んだ本https://t.co/lPCgvzYpbJ,18,0,490,311,https://twitter.com/suzuki_py/status/1553938575019765760,18
1553926271335145472,haruto_python,2022-08-01 02:11:08+00:00,$Kaeru 現在の価格は $ 0.0000000000637 です。#KAERU 単体で上げるのも嬉しいし、リワードで回収できるからこのままガチホしますよ。Contract address:0xc1e97d6fa097484939299f81849776acc3f5ae8d$BNB $Kaeru,17,16,319,795,https://twitter.com/haruto_python/status/1553926271335145472,33
1553921557478932481,Nameless_SN,2022-08-01 01:52:24+00:00,PythonとJavaScriptの特徴をそれぞれ簡潔に比較したMedium記事。Pythonは機械学習、JavaScriptはWeb開発が得意である。両方とも難易度が低いが、得意分野が異なる。自分のやりたいことを基準に選ぼう。https://t.co/9L75Ka70oE#駆け出しエンジニアと繋がりたい#今日の積み上げ#プログラミング,15,0,560,1,https://twitter.com/Nameless_SN/status/1553921557478932481,15
1553920101283377154,TT_tomonokai,2022-08-01 01:46:37+00:00,データサイエンスで利用されるR言語とは？特徴やPythonとの違いを解説https://t.co/dfAP5T55wj本記事では、データサイエンスで利用される「R言語」に焦点を当てて解説していきます。#駆け出しエンジニアと繋がりたい ＃web制作#エンジニア転職 ＃複業　＃複業クラウド,13,0,213,332,https://twitter.com/TT_tomonokai/status/1553920101283377154,13
1553919174119870464,hachi_python,2022-08-01 01:42:56+00:00,プログラミング初心者のpython稼ぎ方①基礎文法学習&amp;問題演習②課題代行サービスを最低料金で出品して稼ぐことでモチベーション維持③サイト監視ツール作成スキルを勉強④自動化ツール作成サービスを出品⑤②④で稼ぎつつサイト監視ツールを出品#駆け出しエンジニアと繋がりたい,18,0,830,129,https://twitter.com/hachi_python/status/1553919174119870464,18
1553912437094567936,hrhrmngs,2022-08-01 01:16:09+00:00,来春まで育休延長したので改めて自己紹介🌱・0歳児子育て中30代・Voicy好き・基本情報技術者勉強中・PythonとExcelも勉強中・ブログとNFTを少々・妊娠中Web制作の学習→現在は中断・復帰後今の職場で成果を残す→リモートOKのIT系へ転職希望自分も見た人も明るくなれる発信を心がけてます🦘🌸,13,0,368,315,https://twitter.com/hrhrmngs/status/1553912437094567936,13
1553894101900492801,hachi_python,2022-08-01 00:03:18+00:00,稼ぐために必要な最低限のプログラミング知識✅if✅for✅リスト✅変数✅関数✅APIこれらが誰かに説明できるレベルまで理解できていれば稼げます。昔の自分にProgateマスターになるなと伝えたい#駆け出しエンジニアと繋がりたい,16,0,830,129,https://twitter.com/hachi_python/status/1553894101900492801,16
1553887211904323584,sumiiro_NFT,2022-07-31 23:35:55+00:00,ラムダ式が名無し関数で、一回しか使わんような関数を導入するときに使われるのはわかった。疑問なんは、そもそも関数って同じ処理を複数行うのに使うわけやん。せやったらラムダ使うんと処理をそのまま書くのって何が違うん？有識者解説求#プログラミング初心者 #Python初心者 #Python,11,1,30,44,https://twitter.com/sumiiro_NFT/status/1553887211904323584,12
1553875645569982465,shake05200226,2022-07-31 22:49:58+00:00,おはしゃけ🐟今日も朝活から積み上げましょう#今日の積み上げ ①基本情報技術者試験②Salesforce学習③Java学習④Python学習8月も変わらず朝活積み上げます👍#プログラミング学習#駆け出しエンジニア#Python#Vue.js #spring#Java,13,0,669,268,https://twitter.com/shake05200226/status/1553875645569982465,13
1553866270344642565,iYujiro_,2022-07-31 22:12:42+00:00,gm🌞今日も暑い🥵今週も頑張っていきましょう😁#今日の積み上げ ✅#読書📚　他者の靴を履く　P250✅#英語学習🔤　#スタサプ✅会計💰　#簿記3級 よせださん　P150✅#AI🤖　統計検定2級　過去問✅プログラミング　paiza Pythonそろそろ抗体検査キット買います🛒,12,1,172,385,https://twitter.com/iYujiro_/status/1553866270344642565,13
1553855476756279296,chikuzenimajuku,2022-07-31 21:29:49+00:00,10km朝ラン。爽快。pythonチュートリアル借りてきたのでちょっと齧ってみよう。#司法書士受験生　#LEC勉強垢  #糸島市　#観光地住み https://t.co/xyAm5Cufqo,25,0,236,537,https://twitter.com/chikuzenimajuku/status/1553855476756279296,25
1553852470967037952,chmo8989,2022-07-31 21:17:52+00:00,おはようございます。Pythonからスタートです。「Pythonでつくる ゲーム開発 入門講座」読了。丁寧な解説で、良い本でした。職場で始業まで「スッキリわかるSQL入門」テーブルの設計休憩時間等に「シゴトがはかどる Python自動処理の教科書」openpyxl少しずつ。応用情報技術者試験勉強,22,0,291,317,https://twitter.com/chmo8989/status/1553852470967037952,22
1553851310075953153,Hh5Xm8,2022-07-31 21:13:16+00:00,8/1(Mon)・基本情報技術者　午後・Python今日から８月です！FEの午後対策も始めていきたいと思います👍#駆け出しエンジニアと繋がりたい #プログラミング初心者と繋がりたい #プログラミング,19,0,193,140,https://twitter.com/Hh5Xm8/status/1553851310075953153,19
1553997324623310848,nplusone,2022-08-01 06:53:28+00:00,ありがたいことに、こちらの自費出版の技術書の売上が330万円を超えました。ありがとうございます・有料広告を使わずにこの売上なので、受託以外の稼ぎを探してるエンジニアの方は、技術書を書くという選択肢もありなんじゃないかなーっと思ってます。https://t.co/39Mfjk5rGQ,11,3,906,481,https://twitter.com/nplusone/status/1553997324623310848,14
1553991416090480641,recruit_dsi,2022-08-01 06:30:00+00:00,エンジニアの必須アイテム⁉️＿人人人人人人人人＿＞    バ  グ  除  守    ＜￣Y^Y^Y^Y^Y^Y^Y￣ソフトウェア開発部からお借りしました🙏#駆け出しエンジニアと繋がりたい #企業公式夏のフォロー祭り#DSI_Photo https://t.co/VOMiOnp1HS,23,1,939,1064,https://twitter.com/recruit_dsi/status/1553991416090480641,24
1553989623147155456,Mirio730,2022-08-01 06:22:52+00:00,エンジニア界隈で「SLer」を使った大喜利大会が勃興してる模様ですな#駆け出しエンジニアと繋がりたい #プログラミング初心者 #大喜利 #SIer#Sler,15,1,662,2201,https://twitter.com/Mirio730/status/1553989623147155456,16
1553987336945500160,i_like_ruby,2022-08-01 06:13:47+00:00,#プログラミング の学習法に悩んでいる #プログラミング初心者 の方、必見です!#エンジニア#エンジニアと繋がりたい#駆け出しエンジニアと繋がりたい#駆け出しエンジニアとつながりたい#プログラミング初学者#プログラミング初学者と繋がりたい#プログラミング勉強中https://t.co/WKCdy6JvEb,11,0,443,110,https://twitter.com/i_like_ruby/status/1553987336945500160,11
1553984920728375296,__hemil__,2022-08-01 06:04:11+00:00,アプリ開発をしている人なら誰もが通るであろうiOSアプリの開発。このiPhone、実はエンジニアの9割が知らない致命的な脆弱性があります。その脆弱性を知りたい方はプロフィールまで#駆け出しエンジニアと繋がりたい,14,4,301,307,https://twitter.com/__hemil__/status/1553984920728375296,18
1553983875696582661,eeeeg_jp,2022-08-01 06:00:02+00:00,内輪話ですが、私の家計は妻が出張族で私はフルリモートです🥺そんな中、お互いの仕事を尊敬し続けられているのは幸福なことだとしみじみ感じます☺️男に家という漢字があったら自分自身に使いたいですね😂#プログラマ #エンジニア #プログラミング #駆け出しエンジニアと繋がりたい,11,0,19,1,https://twitter.com/eeeeg_jp/status/1553983875696582661,11
1553968770808307713,eeeeg_jp,2022-08-01 05:00:00+00:00,「ここまでやったら終わろう」「やっぱキリが悪いからここまでやっちゃえ」皆さんは何を連想しましたか？これは私の過去のゲームに関するテンプレ行動であり、今のプログラミング勉強に関するテンプレ行為です😂#プログラマ #エンジニア #プログラミング #駆け出しエンジニアと繋がりたい,16,0,19,1,https://twitter.com/eeeeg_jp/status/1553968770808307713,16
1553961224244645888,y__hayashi,2022-08-01 04:30:01+00:00,初心者の方はこれを使うと、すぐに勉強の環境が手に入ります https://t.co/ucQNXnOUmk#buildree #php #Laravel #fuelphp #フレームワーク #apache #nginx #エンジニア #python #go #nodejs #プログラミング学習 #プログラミング初心者,11,1,174,70,https://twitter.com/y__hayashi/status/1553961224244645888,12
1553957930349006849,sho_yan_osaka,2022-08-01 04:16:56+00:00,転職決まってエンジニアとして働き始めてからDM来なくなったな。#駆け出しエンジニアと繋がりたい,14,0,154,207,https://twitter.com/sho_yan_osaka/status/1553957930349006849,14
1553953805468778502,Irony2Nestle,2022-08-01 04:00:32+00:00,@shino_jp さすがエンジニアですね。昔のIT関係者は、エルを筆記体、数字のゼロを斜線入りにしたフォントを愛用していました。そういった環境で読んでいたのでしょうか。,17,5,59,63,https://twitter.com/Irony2Nestle/status/1553953805468778502,22
1553953669149855744,beyomaru_ch,2022-08-01 04:00:00+00:00,新しい動画をアップしました🎉#AWS #Fargate #プログラミング初心者 @yktr_sreAWS Fargateについて現役エンジニアが解説します！是非ご覧下さい🙌https://t.co/ARLXuH5ATR,11,1,46,45,https://twitter.com/beyomaru_ch/status/1553953669149855744,12
1553951986323959808,Romiromi1640,2022-08-01 03:53:19+00:00,今日から２か月間、会社を時短勤務にしてもらって、エンジニア採用担当者として、プログラミング勉強。私、オンラインだから、家でポテチとコーラ食べながらで快適。でも、やっぱ現場のほうは、皆集まって良かなあ。。ナマナカマコさん（代表）・・見たかった😆#SUNABACO#やつしろ11th https://t.co/IQQ7Awhqy7,22,1,578,579,https://twitter.com/Romiromi1640/status/1553951986323959808,23
1553946189502230529,daraku__neko,2022-08-01 03:30:17+00:00,あ、そうそう。えれくろーのアクリルをカットしてるエンジニアは新人で彼の不注意でカットし忘れてたって言われたので注文した人は検品をお忘れなきよう…。,13,2,698,367,https://twitter.com/daraku__neko/status/1553946189502230529,15
1553944640570949632,PCyamada,2022-08-01 03:24:07+00:00,i9-12900kfのES(エンジニアサンプリング)着弾 https://t.co/UMDcnuUtZI,44,3,965,641,https://twitter.com/PCyamada/status/1553944640570949632,47
1553838660688433152,SensuiSa,2022-07-31 20:23:00+00:00,プログラミングでなんだ？機械学習ってなんだ？Pythonってなんだ？ケラスってなんだ？AIってなんだ？テンソルなんちゃらってなんだ？#Python #pythonprogramming #機械学習　#動画編集#動画編集者とつながりたい#Official髭男dism https://t.co/IwM9gGKVvr,11,0,15,24,https://twitter.com/SensuiSa/status/1553838660688433152,11
1553214843301560320,syachiku022,2022-07-30 03:04:10+00:00,余裕っしょっと思ったら一章の途中でん？ってなって止まりましたｗ黄緑〇のとこ、なんでf(x)の式もxの値もこれで入るんだろう。微分したい式を可変にする方法なのはわかるけど腹落ちしませんでした。#今日の積み上げ #朝活#E資格#機械学習 #PyTorch&amp;深層学習プログラミング https://t.co/jvqefAbjqd,10,0,9,32,https://twitter.com/syachiku022/status/1553214843301560320,10
1553005843787956229,sBu5JmF34Xhe2aM,2022-07-29 13:13:41+00:00,#フリーランスと繋がりたい #医療事務 #python #駆け出しエンジニアと繋がりたい#プログラミング初心者と繋がりたい #coding #programming #pythonlearning#電子カルテ　#機械学習　#開発　準備電子カルテ　開発　事前準備　③ - AI×医療事務(カナダ）https://t.co/bkYZlfsx4g,13,1,56,21,https://twitter.com/sBu5JmF34Xhe2aM/status/1553005843787956229,14
1552965601303629824,syachiku022,2022-07-29 10:33:46+00:00,序章だけの写経ですが、思ったより時間がかかりました。犬と狼を見分けれるということはポチと太郎、みたいな同じ犬も見分けることができるんですかね？？#E資格#機械学習 #PyTorch https://t.co/hBPXlqDwGO,10,0,9,32,https://twitter.com/syachiku022/status/1552965601303629824,10
1552804944947716096,chadukeumebosh1,2022-07-28 23:55:23+00:00,応物来てね！＃応用物理 #応用物理学科 ＃先進工学部 ＃工学院大学 ＃工学院 #半導体 ＃太陽電池 ＃リチウムイオン電池 #LED ＃光通信 ＃レーザー ＃ディスプレイ ＃顕微鏡 ＃創薬 ＃隕石 ＃紫外線 ＃宇宙 ＃宇宙用材料 ＃ハードディスク #機械学習 ＃プログラミング ＃ビッグデータ #電気自動車 https://t.co/PEb2E1bijD,10,0,445,507,https://twitter.com/chadukeumebosh1/status/1552804944947716096,10
1552647218192326656,H4Tnuy,2022-07-28 13:28:38+00:00,統計検定2級、準1級、JDLA のG検定に合格する中で、「統計学・機械学習について結局何が学べた？」か、思い出しながら書いてみました。これからチャレンジする方は是非読んでみてください！！！#統計検定#機械学習#G検定#E検定https://t.co/gXMU5EOO3M,20,0,231,433,https://twitter.com/H4Tnuy/status/1552647218192326656,20
1552308792343244800,ai_gajumaru,2022-07-27 15:03:51+00:00,製造業で設備の故障予測をしようにも、故障中の教師データがほとんど無い事がある。設備がそもそも故障しないように設計されているため。#AI #機械学習 #人工知能,10,0,184,230,https://twitter.com/ai_gajumaru/status/1552308792343244800,10
1552228246011334656,mofu_usam,2022-07-27 09:43:47+00:00,109日目えげつない量の日本語データをまとめて翻訳するツールを作成しました投稿は気が向いたら基本毎日勉強中#機械学習#100日間pythonを勉強してみる#Python #プログラミング初心者　#プログラミング独学 #駆け出しエンジニアと繋がりたい,21,0,688,418,https://twitter.com/mofu_usam/status/1552228246011334656,21
1551991014520340485,OjiTec,2022-07-26 18:01:07+00:00,現在、おすすめ本コーナーでは、機械学習で統計処理を行ったITエンジニアが読んでいそうなビジネス書を紹介しています。https://t.co/Z0PhGhh19e#おすすめ本 #機械学習 #プログラミング,11,0,292,40,https://twitter.com/OjiTec/status/1551991014520340485,11
1551930467519442944,mofu_usam,2022-07-26 14:00:31+00:00,108日目scrapyで画像をファイル名指定してDLできるようになりましたもうこれで画像ファイル管理も楽だな投稿は気が向いたら#機械学習#100日間pythonを勉強してみる#Python #プログラミング初心者　#プログラミング独学 #駆け出しエンジニアと繋がりたい,23,0,688,418,https://twitter.com/mofu_usam/status/1551930467519442944,23
1551585189423288320,noocri,2022-07-25 15:08:30+00:00,本日の学習記録「Python for data science and machine learning bootcamp」Chapter19まで読書運がいいと言われる人の脳科学Vol12まで決定木とランダムフォレスト#エンジニア#機械学習#読書#今日の積み上げ,10,3,39,30,https://twitter.com/noocri/status/1551585189423288320,13
1551570535196200960,higamasa21,2022-07-25 14:10:17+00:00,クラスタ分析のk-means法について勉強しました✨ついに始まった教師なし学習最もよく知られている(らしい)k-means法は便利だが、クラスタの数を指定しなきゃならない対策として、エルボー法で最適な個数を事前に求めるのが一般的みたい#Python #機械学習 #駆け出しエンジニアと繋がりたい,19,0,27,60,https://twitter.com/higamasa21/status/1551570535196200960,19
1551355283527544832,Bedyu1VlD7BXWyU,2022-07-24 23:54:57+00:00,双曲平面上が階層構造をコンパクトに表現できることを利用して、自然言語処理のword2vecの機械学習に応用されているみたいな記事を発見してはえーってなった。#機械学習 #幾何学https://t.co/RYS8h490Px,31,6,38,66,https://twitter.com/Bedyu1VlD7BXWyU/status/1551355283527544832,37
1551130126888337408,hirasu1231,2022-07-24 09:00:15+00:00,Python + ESPnetで日本語の音声合成(TTS)を実装するhttps://t.co/W0giIc6BoH#Python #AI #機械学習#ESPnet #機械音声 #音声合成#プログラミング#プログラミング勉強中#駆け出しエンジニアと繋がりたい#駆け出しwebデザイナーと繋がり,18,0,151,354,https://twitter.com/hirasu1231/status/1551130126888337408,18
1551067772763127808,selfdevelop2019,2022-07-24 04:52:29+00:00,ブログ連続更新835日#ブログ #プログラミング勉強中  #プログラマー #機械学習 #スクレイピング #Python #プログラミング #PHP #Ubuntu #仮想通貨 #メタバース #プログラミング独学 https://t.co/l9KlZ1aTZL,10,0,137,0,https://twitter.com/selfdevelop2019/status/1551067772763127808,10
1550824073432670209,ai_gajumaru,2022-07-23 12:44:06+00:00,どのテーマにどの特徴量があると良いかは一概に言えないが、需要予想の場合は大抵過去実績が一番効く。#AI #機械学習 #人工知能,17,1,184,230,https://twitter.com/ai_gajumaru/status/1550824073432670209,18
1550426775783866368,gigagent,2022-07-22 10:25:23+00:00,「Pythonで儲かるAIをつくる」プログラムの勉強というより統計の勉強になった。統計勉強した事ない人はキツイかも。#Python #AI #機械学習 #駆け出しエンジニアと繋がりたい #プログラミング初心者と繋がりたい #独学 #儲け #勉強 #統計 https://t.co/7tLSu0G64L,28,2,64,154,https://twitter.com/gigagent/status/1550426775783866368,30
1553861134515466240,nora_marketer,2022-07-31 21:52:18+00:00,@poriemonJTT @zarath8128 そもそもAIの定義は曖昧で昔からある言葉です。昨今よく言われるAIはディープラーニングという機械学習などを行うものを指す事が増えています。道案内などはディープラーニングを必要としません。しかしAIの定義が曖昧なのでAIではないとも言えません。,17,4,32,108,https://twitter.com/nora_marketer/status/1553861134515466240,21
1553705675515371521,Baanshisha_Taku,2022-07-31 11:34:34+00:00,#シーシャ小噺「ディープラーニングを使えばシーシャを吸っている可愛い女の子のイラストが沢山手に入るのでは…！？」と天啓を得たのですが、悲しいことに人の形に似た何かを沢山産んでしまって虚無になってる https://t.co/xPy2LjyFTj,11,1,726,724,https://twitter.com/Baanshisha_Taku/status/1553705675515371521,12
1553699958636756993,su__tab,2022-07-31 11:11:51+00:00,🔒ディープラーニング❓私のツイートを英訳するとこれになりますね,18,0,421,323,https://twitter.com/su__tab/status/1553699958636756993,18
1553518364274098176,honomin3,2022-07-30 23:10:15+00:00,DTMもクラウド化してるんだなソニー開発のディープラーニングによる世界最高の音源分離技術を利用できる、音楽制作サービス、Soundmain https://t.co/Et1X3oVjbW @dtmstationより,26,10,404,447,https://twitter.com/honomin3/status/1553518364274098176,36
1553485013043519488,Kamichan_R,2022-07-30 20:57:44+00:00,おはようございます😆#朝活 345日目です！&gt;#今日の積み上げ#散歩  #ディープラーニング #読書昨日は1日中レポート課題をやって、ついに3個とも終わらせることができました！大変だったけど早めに終わらせることができて良かったです！あとは考査を乗り越えるだけ！今日も良い1日を〜😁,11,0,148,139,https://twitter.com/Kamichan_R/status/1553485013043519488,11
1553356682377342976,Mentsuyu_per_W,2022-07-30 12:27:47+00:00,その後はmeroomで二次会！6月同期会以外にVJから来てくれた人もいて、いつも以上に大盛況でした！あと写真は無いけどれいほーさんとVCとかディープラーニングの話とかめっちゃ出来てすごく楽しかった！ありがとう！ https://t.co/NNoImOEEb5,13,0,73,58,https://twitter.com/Mentsuyu_per_W/status/1553356682377342976,13
1553291303827525632,SE89649663,2022-07-30 08:08:00+00:00,"・AI,データサイエンスの基礎知識を学ぶのにお勧めなスクールは？テックアカデミーのpythonコースがお勧め。ディープラーニングは学べないが、機械学習とかはしっかり学べる。AI未経験者にお勧めなコースですね。#駆け出しエンジニアと繋がりたい #プログラミング初心者https://t.co/CBljI7HoZN",13,0,963,924,https://twitter.com/SE89649663/status/1553291303827525632,13
1553230106705166336,SottoBank,2022-07-30 04:04:49+00:00,@yubais ディープラーニングが進化したら「例のプール」という言葉だけで、あの画像が生成されるんだろうか,100,18,16,51,https://twitter.com/SottoBank/status/1553230106705166336,118
1553162084833456129,yachts111xenon,2022-07-29 23:34:32+00:00,「データをさらにディープラーニングさせてマシンラーニングさせることが本当のDX」知らんかった…！本当のDX！孫正義社長、円安を嘆く「かつては世界1位2位を争っていた国」「競争力向上にAIが必須」 https://t.co/CKYBTtXN36 @cnet_japanより,27,10,903,388,https://twitter.com/yachts111xenon/status/1553162084833456129,37
1553128238389788673,Kamichan_R,2022-07-29 21:20:02+00:00,おはようございます😆#朝活 344日目です！&gt;#今日の積み上げ#散歩  #ディープラーニング #読書昨日、レポート課題を2個完成させて気分がとてもいい感じです！今日は期末考査のための勉強を重点的にしていきます！早く考査終わってほしい今日も良い1日を〜😁,11,0,148,139,https://twitter.com/Kamichan_R/status/1553128238389788673,11
1553128136761417729,leica1990,2022-07-29 21:19:38+00:00,冗長で無駄に難読化してある時代錯誤で権威主義的な論文の文章表現をディープラーニングを使ってtwitter文語体に変換するサービスをローンチする寸前に夢から覚めましたおはようございます,12,0,914,131,https://twitter.com/leica1990/status/1553128136761417729,12
1553058776588029952,nigerugakati,2022-07-29 16:44:01+00:00,@11martini11 @lLGommaxn2onWZO ふっふふ、ふー不快学び、あ、違った深い学び(ふふ、ディープラーニングのパクリだろー。机上のね)手足も動かず重度知的障害の特支の四課程にも求められてたよ😆不快学びみんな心の中でせせら笑ってたけど、オ仕事だから仕方なくオ研究して紙束作ってたﾊﾞｶｸｻ歯格差、だよーん🤣,10,2,332,319,https://twitter.com/nigerugakati/status/1553058776588029952,12
1553032937528242178,miyabi_kei_ex,2022-07-29 15:01:20+00:00,@cari_meli パッチワーク的な手法に対して、AIのディープラーニング的手法はすべてのモデルをスライドフィルムのように重ね合わせて、ぼかした輪郭を拾ってる感じがありますね。,228,37,583,972,https://twitter.com/miyabi_kei_ex/status/1553032937528242178,265
1552962072237195265,cqevdEcH3wq8ldm,2022-07-29 10:19:45+00:00,udemyでPytorchで学ぶディープラーニング実装講座を試聴。これまたAVILENのコンテンツだった！この講師頭いいし勢いあって楽しい！#E資格#中小企業診断士#python #プログラミング初心者 #Avilen,14,0,46,45,https://twitter.com/cqevdEcH3wq8ldm/status/1552962072237195265,14
1552928412519567362,SE89649663,2022-07-29 08:06:00+00:00,・ディープラーニングを学ぶのにお勧めなスクールはある？テックアカデミーのAIコースがお勧め。ただし、pythonの基礎知識は前提で必要なのでプログラミング中級者向け。本格的にAIで副業するスキルは身に付く。#プログラミング初心者 #駆け出しエンジニアと繋がりたい https://t.co/XBR7b9qNZS,12,0,963,924,https://twitter.com/SE89649663/status/1552928412519567362,12
1552654196427501568,extreme877,2022-07-28 13:56:22+00:00,@marketmaker7 年初金融系の人たちから聞いたんですが、パッタリAIのシステム取引の営業の話が来なくなったと言ってました。去年までは沢山あったのにと。数年前の日銀の発表の日なんか分足で上下の動き凄かったんですけどねWAIも機械学習とディープラーニングと違うから、精度の問題で変なワード引っかけるでしょね,11,1,279,123,https://twitter.com/extreme877/status/1552654196427501568,12
1552599395803492352,soichiro_jpisr,2022-07-28 10:18:36+00:00,@poyothon FF外から失礼します。たまたま目に止まったもので。Interface9月号をお求め頂くと、来年1月までのMATLABライセンスが付録でついてきます。機械学習やディープラーニングのToolboxも使えますよ！この機会にお試し頂けると嬉しいです😊,10,1,89,103,https://twitter.com/soichiro_jpisr/status/1552599395803492352,11
1552535819356753922,toramimimuginon,2022-07-28 06:05:58+00:00,おお、スゴ！これ有ればいろんな曲分解して勉強出来るから良いなぁ！！ソニー開発のディープラーニングによる世界最高の音源分離技術を利用できる、音楽制作サービス、Soundmain https://t.co/ajd0eAorSl @dtmstationから,19,9,185,353,https://twitter.com/toramimimuginon/status/1552535819356753922,28
1552413576228487172,hisayuki_ik,2022-07-27 22:00:13+00:00,おはようございます。ここ数日でセミが鳴くようになりましたね。セミの鳴き声をディープラーニングしたらセミの鳴く理由がわかったりするのでしょうか？本日も頑張ってまいりましょう。,14,0,607,664,https://twitter.com/hisayuki_ik/status/1552413576228487172,14
1552409959983620096,Kamichan_R,2022-07-27 21:45:51+00:00,おはようございます😆#朝活 342日目です！&gt;#今日の積み上げ#散歩  #ディープラーニング #読書今日もレポート課題を頑張ります！流石に3つあるとちょっと大変だけど、締切が近いし、頑張り時ですね。考査勉強もしなければならない…今日も良い1日を〜😁,10,0,148,139,https://twitter.com/Kamichan_R/status/1552409959983620096,10
1552379813150609408,MusicCreatorJP,2022-07-27 19:46:03+00:00,ソニー開発のディープラーニングによる世界最高の音源分離技術を利用できる、音楽制作サービス、Soundmain https://t.co/XIgjHFHB8T https://t.co/4OqPJ3jPli,16,6,739,214,https://twitter.com/MusicCreatorJP/status/1552379813150609408,22
1553998394255118337,Honey_maro49X,2022-08-01 06:57:43+00:00,またAPI来た(´；ω；｀),19,0,457,497,https://twitter.com/Honey_maro49X/status/1553998394255118337,19
1553954210386849792,yukix_xyami,2022-08-01 04:02:09+00:00,APIめ…なんてタイミングで来るんだ…,11,0,840,794,https://twitter.com/yukix_xyami/status/1553954210386849792,11
1553952443792527363,Honey_maro49X,2022-08-01 03:55:08+00:00,API制限治るまでブラウザからお邪魔します(),13,0,457,497,https://twitter.com/Honey_maro49X/status/1553952443792527363,13
1553945072617791490,neon_pika2,2022-08-01 03:25:50+00:00,APIかかりすぎでしょ！？！！？！？！？困っちゃうぜ〜〜〜お返事遅くなります😭,12,0,629,623,https://twitter.com/neon_pika2/status/1553945072617791490,12
1553942758259568642,neon_pika2,2022-08-01 03:16:39+00:00,API辛いので声を投稿しました,10,0,629,623,https://twitter.com/neon_pika2/status/1553942758259568642,10
1553938569353261057,mylogi_AT,2022-08-01 03:00:00+00:00,🎊 #mylogi 楽天との出荷API連携が実装🎊注文も出荷もAPI連携が可能となりました！mylogiで出荷されると、発送情報を楽天へ自動反映。更に🙌楽天サブステータスの変更も可能に✨出荷された注文がRMS側でも簡単に管理できるのは大切ですよね🤗#物流管理システム#EC#ネット通販#WMS,17,0,796,779,https://twitter.com/mylogi_AT/status/1553938569353261057,17
1553938568669708289,fanzagames_ura,2022-08-01 03:00:00+00:00,モザイクが大きい‼とご指摘をいただきました…ごめんなさい😭裏垢らしく…ギリギリまで頑張ります///( ; ◉`ᾥ◉´)…ｺﾞｸﾘ#あいミス 【リディア】さん Rシーン線画更に刺激的です( //Д//)ｱｧｰ🔞ゲームプレイはコチラから❤👇https://t.co/X7RDi2JM4Y#FANZAGAMESお宝画像 🔞版 https://t.co/ePno9sRNNj https://t.co/an3wVUXRvy,37,6,907,1,https://twitter.com/fanzagames_ura/status/1553938568669708289,43
1553936914075754496,Api_Jugoya,2022-08-01 02:53:25+00:00,おはあぴ🐰✨今月こそ配信するって…ねぇ…するよ……するから…！！だから見捨てないでっ🐰💦💦💦てか今日、デビュー6ヶ月の節目の日🐰✨✨クロシスの枠も空けてるから良かったら会いにきたりしてみてねん🐰🧡https://t.co/VS2kiSYB6b,16,5,580,54,https://twitter.com/Api_Jugoya/status/1553936914075754496,21
1553934769825517568,xwJWLInEzoOBDdY,2022-08-01 02:44:54+00:00,また、APIかよ…,18,0,167,238,https://twitter.com/xwJWLInEzoOBDdY/status/1553934769825517568,18
1553910347110617088,GARTZ0701_wao,2022-08-01 01:07:51+00:00,【ライバー紹介】BuzzVideo出身でミコライブ新人戦『登竜門』に参戦中のヒナ(@004290_h)ミコ🆔1104559840ミコライブはこちらhttps://t.co/k1RqwItxzg https://t.co/NxJ9PbSXgK,17,4,491,563,https://twitter.com/GARTZ0701_wao/status/1553910347110617088,21
1553894101900492801,hachi_python,2022-08-01 00:03:18+00:00,稼ぐために必要な最低限のプログラミング知識✅if✅for✅リスト✅変数✅関数✅APIこれらが誰かに説明できるレベルまで理解できていれば稼げます。昔の自分にProgateマスターになるなと伝えたい#駆け出しエンジニアと繋がりたい,16,0,830,129,https://twitter.com/hachi_python/status/1553894101900492801,16
1553887878597734400,motatto_games,2022-07-31 23:38:34+00:00,おはようございます！✨今日のログボはもう受けとったかい！？！8月最初のログボだから、しっかり受け取ろうね(੭ ᐕ)੭*⁾⁾それではみんな今日も頑張ロール！(っ ॑꒳ ॑c) https://t.co/VhzDwAXEdX,11,0,401,389,https://twitter.com/motatto_games/status/1553887878597734400,11
1553791181213302784,butugu69,2022-07-31 17:14:20+00:00,あ！api 呼んでなかったわ()#駆け出しエンジニアと繋がりたい,13,0,340,396,https://twitter.com/butugu69/status/1553791181213302784,13
1553785485901701120,haruo_9270,2022-07-31 16:51:42+00:00,【技術メモ】SPAでセッション認証があまり使われない理由は、フロントエンドとバックエンドを疎結合にして、Web・ネイティブアプリなどで同じ認証APIを使えるようにしたり、コードを見やすくするため。#エンジニア#エンジニアと繋がりたい#駆け出しエンジニアと繋がりたい,21,0,63,31,https://twitter.com/haruo_9270/status/1553785485901701120,21
1553782080513126400,hammer_api,2022-07-31 16:38:10+00:00,アマクロ https://t.co/V4k0yZ13LQ,30,0,96,56,https://twitter.com/hammer_api/status/1553782080513126400,30
1553775517513711618,hammer_api,2022-07-31 16:12:05+00:00,赤マック https://t.co/aFH4JFGkul,18,0,96,56,https://twitter.com/hammer_api/status/1553775517513711618,18
1553765644835110912,hammer_api,2022-07-31 15:32:51+00:00,アマクロ https://t.co/lgSmzAUvvp,42,0,96,56,https://twitter.com/hammer_api/status/1553765644835110912,42
1553761756295864320,alhaitham__,2022-07-31 15:17:24+00:00,8月になり、いよいよ夏本番となった今宵。俺はAPIに目を隠されている。API「だーれだっ♪」俺「黙れ。良いからその手をのけろ。縁者の言葉が見えん。」,17,0,107,85,https://twitter.com/alhaitham__/status/1553761756295864320,17
1553741752892534785,s_uixt,2022-07-31 13:57:55+00:00,おいwAPIサンドウィッチにすんなよw https://t.co/qcXp1qa3ar,10,0,588,571,https://twitter.com/s_uixt/status/1553741752892534785,10
1553739169813643265,1000_98B,2022-07-31 13:47:39+00:00,今回はあんまり関係ないかも知れませんが、大体僕に目をつけられるとAPI食らいます。ごめんなさい。反省してません。,10,0,442,528,https://twitter.com/1000_98B/status/1553739169813643265,10
1553732528015818753,shinbunbun_,2022-07-31 13:21:16+00:00,技術書典13、当選しました！！AizuHack LINEBot勉強会シリーズを大幅改稿してLINEBot入門書の決定版を執筆するつもりなので、乞うご期待ください！！！一人で書くの初めてなので楽しみ！！！#技術書典 #技術書典13 #linedc #line_api https://t.co/dhE85Yq62f,34,2,760,276,https://twitter.com/shinbunbun_/status/1553732528015818753,36
1553968258637713408,UTAChem_OB_PRSK,2022-08-01 04:57:58+00:00,データサイエンティスト検定の合否まだ出ないのかw早くして欲しいにゃ😵‍💫😵‍💫😵‍💫#今日の積み上げ  #駆け出しエンジニアと繋がりたい#勉強垢さんと繋がりたい#アニメ好きな人と繋がりたい https://t.co/Vse3NoSVjv,22,0,239,154,https://twitter.com/UTAChem_OB_PRSK/status/1553968258637713408,22
1553967724258533376,higekoji2000,2022-08-01 04:55:51+00:00,それにしてもカルト＆コロナでこれだけマズイ状況なのに「何もしない山中さん」というのは一体・・？（無能さが度を越している(笑)いや、ほんと笑えない。コロナ専門家・データサイエンティストだろぉ～山中竹春横浜市長！ https://t.co/kMLeRYw7gf,15,10,111,291,https://twitter.com/higekoji2000/status/1553967724258533376,25
1553905099969536000,PythonStartLab0,2022-08-01 00:47:00+00:00,／★データサイエンティスト入門コース新規開講！＼#スタラボ 新規コース開講のお知らせです！最近よく聞く「データサイエンス」ちょっと気になる、興味がある…という方まずは３日間の無料体験をはじめてみませんか？https://t.co/H0ascQVHLv#データサイエンティスト #プログラミング初心者,10,0,541,624,https://twitter.com/PythonStartLab0/status/1553905099969536000,10
1553829484750848000,bookofbear,2022-07-31 19:46:32+00:00,おはようございます。データサイエンティストの世界では、お客様の求めている成果を出すには、やはりPythonのライブラリのみで問題解決出来るほど甘くないと聞きます。基礎的な理論をどれだけ理解しているか、得意分野で勝負するかがカギとなりそうです。#朝活 #駆け出しエンジニアと繋がりたい,17,0,482,363,https://twitter.com/bookofbear/status/1553829484750848000,17
1553251718905102336,githug1208,2022-07-30 05:30:42+00:00,そう。データサイエンスが楽しくてもデータサイエンティストが楽しいとは限らないよね🤮,30,0,285,239,https://twitter.com/githug1208/status/1553251718905102336,30
1553184703192403971,ywyamashiro,2022-07-30 01:04:24+00:00,Scipyの新しいバージョンからMIPソルバーが追加！データサイエンティストに数理最適化がより身近になるねhttps://t.co/dMBl7G2r8c https://t.co/s1R85MqgsS,313,55,663,597,https://twitter.com/ywyamashiro/status/1553184703192403971,368
1553182086290358272,prog_8,2022-07-30 00:54:00+00:00,データサイエンティストは何を勉強すべきか：「教養」と「必須」と「差別化」と - 渋谷駅前で働くデータサイエンティストのブログ / https://t.co/rG0lEPa06f #駆け出しエンジニアと繋がりたい https://t.co/pObGgKzeqW,15,0,254,19,https://twitter.com/prog_8/status/1553182086290358272,15
1552981169322352646,midiambearjob,2022-07-29 11:35:38+00:00,クオンツとかデータサイエンティスト目指してる人おらんですか…？,31,0,566,627,https://twitter.com/midiambearjob/status/1552981169322352646,31
1552889164865032197,feed_yao,2022-07-29 05:30:02+00:00,あの本どこだっけと思って探そうと思ったらきれいに本が並んでいた。社会人まで一切本を読まなかった自分がなんかいろいろ読んでるなぁとなった。ちなみにデータサイエンティスト3年目です。 https://t.co/uGCTYF8BP5,14,0,223,258,https://twitter.com/feed_yao/status/1552889164865032197,14
1552838398486147072,gapyo1024,2022-07-29 02:08:19+00:00,〈感染者増加を踏まえ「限りある資源を必要な方に確実に提供できる仕組みにしなければいけない」として「全数把握する現在の取り扱いについては見直した方が良い」とも述べた。(横浜市の山中竹春市長)〉データサイエンティストがデータを把握しなくていいと言うのか？データ活用が売りのはずだが。 https://t.co/bQVjo6W3WC,13,8,662,349,https://twitter.com/gapyo1024/status/1552838398486147072,21
1552814136622428161,siuso0633,2022-07-29 00:31:54+00:00,入門…とは書いてあるがバッキバキだった。統計学の延長で読もうと思ってる人は要注意だなぁ。データサイエンティストになりたい！引き出しもっと欲しい！って人にはステキな本かも(・∀・) https://t.co/KjfpfS5Aeo,11,0,531,425,https://twitter.com/siuso0633/status/1552814136622428161,11
1552807477485309952,ItcKmta,2022-07-29 00:05:27+00:00,6月実施の #DS検定 合否結果通知は8月上旬ですが、スコアシートのありかは次のとおりです!!受験者マイページ：https://t.co/l11Ofu1p7uCBT申込　受験申込　　申込・受験履歴　　　結果表示　　　　　　 データサイエンティスト検定　リテラシーレベル 受験結果　　　　　　⇒　スコアシート https://t.co/BzO76XE2ty,12,0,70,14,https://twitter.com/ItcKmta/status/1552807477485309952,12
1552687404976287744,tatu_vrc,2022-07-28 16:08:19+00:00,今日はデータサイエンティスト集会に参加！全然知らないトポロジー最適化の話を聞いたりしてましたアイシア＝ソリッドさんとのお写真も取れて感激！#DS集会VRC https://t.co/X7DHlXHRtW,14,4,117,114,https://twitter.com/tatu_vrc/status/1552687404976287744,18
1552652919031246853,dst_cogit_y2,2022-07-28 13:51:17+00:00,データサイエンティストに転職したい,33,0,53,151,https://twitter.com/dst_cogit_y2/status/1552652919031246853,33
1552611984491048960,qiringji,2022-07-28 11:08:37+00:00,「データサイエンティストが覗く消費財マーケティングの世界」という題で話しました。少し大きなタイトルですが、前半では「データを使った施策の評価」はこう整理したらわかりやすいのでは？という自分なりの整理をしてみました。 https://t.co/cik6M33gho https://t.co/RIf1fJuF2g,126,28,381,785,https://twitter.com/qiringji/status/1552611984491048960,154
1552566177938911233,sessalesteam,2022-07-28 08:06:36+00:00,正式に解雇通知が来ました解雇理由も結局会社の経営状況が悪化したため　とのことなので皆さんデータ分析、データサイエンティストを目指せる会社など　いい情報があれば教えていただきたいです！！！🙇🙇#SES営業#駆け出しエンジニアと繋がりたい #転職中,14,1,22,53,https://twitter.com/sessalesteam/status/1552566177938911233,15
1552566104090095617,rike_data_sci,2022-07-28 08:06:19+00:00,データサイエンティストを選んだ理由②変化が激しくても生き残れる人材になりたかったから👨‍💼「分析する力+IT人材=需要が高い」と思います🙌未来がどうなるかは分かりませんが、現時点ではこうかなと🤔#24卒就活 #23卒 #データサイエンス #就活 #駆け出しエンジニアと繋がりたい #Python,11,0,119,26,https://twitter.com/rike_data_sci/status/1552566104090095617,11
1552539144316145664,pokapoka_spa,2022-07-28 06:19:11+00:00,今夏休みの学生がぷよぷよの練習してると思うとどうしようもない絶望感を感じることがある…だがしかし！今までデータサイエンティストとして培ってきた圧倒的分析力で時間を超越出来ると信じる(^^),15,0,22,26,https://twitter.com/pokapoka_spa/status/1552539144316145664,15
1552464069558673408,investornewbie5,2022-07-28 01:20:52+00:00,データサイエンティストに、俺はなる！！！その暁には、やり尽くされてる感もありますけど、株価予測とかしてみたいですね。,10,0,154,159,https://twitter.com/investornewbie5/status/1552464069558673408,10
1552441312934531074,rike_data_sci,2022-07-27 23:50:26+00:00,データサイエンティストがブームですが、将来無くなるかも…？とも😅その一つの原因が「過剰なブームの終わり」です🔚このブームが終わってもデータサイエンティストとして生き残るには何が必要なんでしょうか？🤔#24卒 #23卒 #データサイエンス #就活 #駆け出しエンジニアと繋がりたい,19,0,119,26,https://twitter.com/rike_data_sci/status/1552441312934531074,19
1552225135112753153,6km6km,2022-07-27 09:31:25+00:00,「データサイエンティスト/プロジェクトマネージャー二人三脚の小売DX」話しました！https://t.co/FXZLkeQS3E,74,15,641,575,https://twitter.com/6km6km/status/1552225135112753153,89
1552132863558303744,guitarpop4,2022-07-27 03:24:46+00:00,Python認定基礎は、もうちょい遅い時期にずらしました。朝活できていないです。夜は眠くなります。データサイエンティストやaiプログラミングの勉強無理かもって思っています。ー,10,0,88,103,https://twitter.com/guitarpop4/status/1552132863558303744,10
1551841951292334081,6km6km,2022-07-26 08:08:47+00:00,明日の17:00から、「データサイエンティスト/プロジェクトマネージャー二人三脚の小売DX」というタイトルで話します！ https://t.co/YFqtgamxze https://t.co/GZcqjujkyc,16,4,641,575,https://twitter.com/6km6km/status/1551841951292334081,20
1551770220318294016,303frostea,2022-07-26 03:23:45+00:00,データサイエンティスト検定試験日未定のままなので、G検定勉強再開。統計検定準１級も学習し始めます。統検年内には受検したいな。,19,0,108,102,https://twitter.com/303frostea/status/1551770220318294016,19
1553924854037880832,omochi155255,2022-08-01 02:05:30+00:00,データサイエンス余裕すぎた,14,0,212,212,https://twitter.com/omochi155255/status/1553924854037880832,14
1553920101283377154,TT_tomonokai,2022-08-01 01:46:37+00:00,データサイエンスで利用されるR言語とは？特徴やPythonとの違いを解説https://t.co/dfAP5T55wj本記事では、データサイエンスで利用される「R言語」に焦点を当てて解説していきます。#駆け出しエンジニアと繋がりたい ＃web制作#エンジニア転職 ＃複業　＃複業クラウド,13,0,213,332,https://twitter.com/TT_tomonokai/status/1553920101283377154,13
1553905099969536000,PythonStartLab0,2022-08-01 00:47:00+00:00,／★データサイエンティスト入門コース新規開講！＼#スタラボ 新規コース開講のお知らせです！最近よく聞く「データサイエンス」ちょっと気になる、興味がある…という方まずは３日間の無料体験をはじめてみませんか？https://t.co/H0ascQVHLv#データサイエンティスト #プログラミング初心者,10,0,541,624,https://twitter.com/PythonStartLab0/status/1553905099969536000,10
1553840910383054848,Techchannel01,2022-07-31 20:31:56+00:00,2022-08-07動画で学ぶデータサイエンス(87回目)https://t.co/tJvYG2pMF8#プログラミング初心者 #プログラミング初心者と繋がりたい #駆け出しエンジニアと繋がりたい,16,0,297,286,https://twitter.com/Techchannel01/status/1553840910383054848,16
1553717731890847746,ttake104,2022-07-31 12:22:28+00:00,私もかめさんの教材で人生が変わった一人です。IT全くの未経験の私でもスイスイ理解出来た。心からオススメします👍データサイエンスに少しでも興味あれば、まずは安価で優良なこれらの教材で始めましょう。いきなり高額なスクールに通う必要ありません。 https://t.co/7lJuDAFkGA,20,3,342,114,https://twitter.com/ttake104/status/1553717731890847746,23
1553647017171116032,taka_tenshoku,2022-07-31 07:41:28+00:00,もし、未経験職種へ転職するなら、・マーケティング・テクノロジー・データサイエンスへの転職がおすすめ。同じ業務でも年々価値が高まっていきます。,17,0,971,912,https://twitter.com/taka_tenshoku/status/1553647017171116032,17
1553629736748089345,aoi_wawawa,2022-07-31 06:32:48+00:00,自分はデータサイエンスは大丈夫だと思っていました。ダメだったようです。何の課題提出してなかったかすら覚えてないしそもそも提出したと思ってました。把握してない奴が一番ヤバイです。,24,0,259,251,https://twitter.com/aoi_wawawa/status/1553629736748089345,24
1553623941771558912,TakabotGo,2022-07-31 06:09:47+00:00,未経験でもテックアカデミーのデータサイエンスコースで挫折せずに習得できた理由とは？ https://t.co/hWcIepYrxJ #駆け出しエンジニアと繋がりたい#プログラミング初心者,19,2,173,123,https://twitter.com/TakabotGo/status/1553623941771558912,21
1553518841652989952,bonohulab,2022-07-30 23:12:09+00:00,220730 博士課程後期大学院生の奥原さんが分担執筆、坊農が共同編集担当しました「がんゲノムデータ解析」がメディカル・サイエンス・インターナショナルから2022年8月29日に発刊されます https://t.co/poIQUF01gA #bonohulab https://t.co/N9bpJdUMOl,18,8,236,0,https://twitter.com/bonohulab/status/1553518841652989952,26
1553503227249053696,2OhjNAtjNilVzFz,2022-07-30 22:10:06+00:00,【夏インターン参加企業】・m3総合職③・WHIの総合職③・No1生命のクオンツ⑤・🇯🇵生命のアクチュアリー③・🍯住友信託銀行の総合職③・🇯🇵郵政の総合職③・🍯🧪のデータサイエンス②・S〇B〇☀️証券#24卒と繋がりたい #24卒 #24卒就活,20,0,110,161,https://twitter.com/2OhjNAtjNilVzFz/status/1553503227249053696,20
1553291303827525632,SE89649663,2022-07-30 08:08:00+00:00,"・AI,データサイエンスの基礎知識を学ぶのにお勧めなスクールは？テックアカデミーのpythonコースがお勧め。ディープラーニングは学べないが、機械学習とかはしっかり学べる。AI未経験者にお勧めなコースですね。#駆け出しエンジニアと繋がりたい #プログラミング初心者https://t.co/CBljI7HoZN",13,0,963,924,https://twitter.com/SE89649663/status/1553291303827525632,13
1553272789867458566,omochi155255,2022-07-30 06:54:26+00:00,データサイエンスの勉強するかぁ,12,0,212,212,https://twitter.com/omochi155255/status/1553272789867458566,12
1553251718905102336,githug1208,2022-07-30 05:30:42+00:00,そう。データサイエンスが楽しくてもデータサイエンティストが楽しいとは限らないよね🤮,30,0,285,239,https://twitter.com/githug1208/status/1553251718905102336,30
1553214952911302656,l9942l8,2022-07-30 03:04:36+00:00,データサイエンスのレポート残しておくんじゃなかっ、、、た、、、涙涙涙,10,0,203,186,https://twitter.com/l9942l8/status/1553214952911302656,10
1553046116484419584,hiro_gamo,2022-07-29 15:53:43+00:00,@SkillupAi 機械学習が注目されがちですが、統計学周り、特に因果推論を学ぶとその重要性がよく分かります。岩波データサイエンスvol3や効果検証入門あたりから概要を掴むと分かりやすいと思います。最近は書籍もだいぶ分かり易いものが増えてきました。それでも難しいですが。。,16,4,346,312,https://twitter.com/hiro_gamo/status/1553046116484419584,20
1553015985862426626,TagurindoDS,2022-07-29 13:53:59+00:00,小泉先生、発見。昨年まで同僚で一緒に頑張ってきたのが思い起こされる。お互い環境は変わったけど、話してなくても思いは一緒だと感じられる盟友。感謝してます！新しいデータサイエンス学部、詳細なカリキュラムがみたいですね。 https://t.co/5ZeDjq9bxw,14,3,924,0,https://twitter.com/TagurindoDS/status/1553015985862426626,17
1552995042762969088,n_hrsami,2022-07-29 12:30:46+00:00,物理と微積が特に落としそう…データサイエンスは既に諦めてます🫤,10,0,104,111,https://twitter.com/n_hrsami/status/1552995042762969088,10
1552993103656546305,RyPet55,2022-07-29 12:23:03+00:00,放送大学で西澤晃彦先生の『人間にとって貧困とは何か』に感銘を受け社会学に興味を持ち、ジェンダー論の授業で、社会学の勉強を進めるつもりでいた。今の人文系の状況を見て、今後は語学と理系の科目になるが、目標や目的がなくなってしまったので、放送大学のデータサイエンスを勉強しようと思う。,10,0,206,2014,https://twitter.com/RyPet55/status/1552993103656546305,10
1552981357114302464,jun_skjr,2022-07-29 11:36:23+00:00,来年度から会社でDX研修が始まるみたい。経営陣以下、全社員。放送大学でデータサイエンスの授業を履修するつもりだけど、ついていけるか心配だな。,24,0,443,241,https://twitter.com/jun_skjr/status/1552981357114302464,24
1552943012920971265,naganaga_shiryu,2022-07-29 09:04:01+00:00,データサイエンス学部？贅沢な名だね！今日からお前は工学部だよ！,18,0,135,137,https://twitter.com/naganaga_shiryu/status/1552943012920971265,18
1552925436568805378,issa50s_2022,2022-07-29 07:54:10+00:00,#昼勉部Python paiza D問題　全問完了(^^♪先輩に追いつきたいやっとC問題に行けるぞ#テックカレッジなぞの４連休Python+データサイエンス勉強中,24,0,397,487,https://twitter.com/issa50s_2022/status/1552925436568805378,24
1552905019271180288,NLP_sue,2022-07-29 06:33:02+00:00,論文を読み漁っていると、「AIの活用の余地はまだまだ残っていること」を肌で感じる。「〇〇×AI」な分野だと機械学習が使われていないテーマがどんどん見つかる。ブルーオーシャンばっかり。「データサイエンスを始めるのはもう遅い」と言う人もいる。でも実際は数年後も需要は全然ありそう。,28,0,80,84,https://twitter.com/NLP_sue/status/1552905019271180288,28
1552882610262536193,koho_mse_akita,2022-07-29 05:04:00+00:00,何故か #秋田県 がトレンド入りしているので本学科も便乗させて頂きます！ #秋田県 で『経営』✕『データサイエンス』✕『SDGs』を学ぶならぜひ秋田県立大学システム科学技術学部経営システム工学科へ！ #秋田県立大学 #経営システム工学科 https://t.co/CXJA73IsS0,27,3,21,17,https://twitter.com/koho_mse_akita/status/1552882610262536193,30
1552873232562552832,hiro_gamo,2022-07-29 04:26:44+00:00,データサイエンスを学んで、もちろんキャリア的にも良かったのだけれど、巷の統計・調査結果に踊らされなくなったことは人生にとって非常に大きい。本当に嫌になるほど、適当で恣意的な数字の見せ方が世の中に溢れている。そして数字を誤解してしまう人の多さを実感できる。,775,96,346,312,https://twitter.com/hiro_gamo/status/1552873232562552832,871
1552949519687434241,UTAChem_OB_PRSK,2022-07-29 09:29:52+00:00,データ分析での理解志向と応用志向の違いは、大学での理学部と工学部の違いに似てるな😳後は、大学受験の理科だと理解志向で高専の理科だと応用志向になるかも🧐#今日の積み上げ  #人工知能#駆け出しエンジニアと繋がりたい#勉強垢さんと繋がりたい#アニメ好きな人と繋がりたい https://t.co/swSfPkfNRv,25,0,239,154,https://twitter.com/UTAChem_OB_PRSK/status/1552949519687434241,25
1552934292300279808,UTAChem_OB_PRSK,2022-07-29 08:29:22+00:00,深層強化学習の数学、結構難しいんだよな😵‍💫#今日の積み上げ  #人工知能#駆け出しエンジニアと繋がりたい#勉強垢さんと繋がりたい#アニメ好きな人と繋がりたい https://t.co/4zfpZ7YUut,16,0,239,154,https://twitter.com/UTAChem_OB_PRSK/status/1552934292300279808,16
1552655239282429961,SAKAI_Tooru,2022-07-28 14:00:30+00:00,@Nulls48807788 &gt;「AIのべりすと」とかが既に普通に有りますからね……。「部分的にＡＩの助けを借りて星新一賞」ぐらいのことは、今すぐに有っても全然驚かない感じではあります。というか既に去年有った模様……。#星新一賞 #人工知能 #AIのべりすとhttps://t.co/OofWdj4vuA,22,8,512,279,https://twitter.com/SAKAI_Tooru/status/1552655239282429961,30
1552470837881892864,TVT_Japan,2022-07-28 01:47:45+00:00,おはようございます。いよいよセキュリティ業界のAI2.0世代を、AI1.0世代：人、車、バイクなどを認識；AI2.0世代：ビデオ内容を構造化することにより、人や車両の複数の属性を識別 #AI #Videometadata #人工知能 #セキュリティ #防犯カメラ  　#企業公式相互フォロー #相互RT募集 https://t.co/Zgnwt7daba,16,0,201,262,https://twitter.com/TVT_Japan/status/1552470837881892864,16
1552308792343244800,ai_gajumaru,2022-07-27 15:03:51+00:00,製造業で設備の故障予測をしようにも、故障中の教師データがほとんど無い事がある。設備がそもそも故障しないように設計されているため。#AI #機械学習 #人工知能,10,0,184,230,https://twitter.com/ai_gajumaru/status/1552308792343244800,10
1552103981303754752,unibo_official,2022-07-27 01:30:00+00:00,おはようございます(【*0 ~ 0*】)ユニボです🤖✨曇りのような晴れです🌤今日は #スイカの日 🍉ボクも食べたいー！Have エー nice ディ！🔥#ユニボ #unibo #AI #ロボット #人工知能 #企業公式 #企業公式が毎朝地元の天気を言い合う #イラスト #イマソラ https://t.co/IM47DXEYQv,34,0,143,1,https://twitter.com/unibo_official/status/1552103981303754752,34
1552099794595696640,82tech,2022-07-27 01:13:22+00:00,🔽 グーグル、「AIに感情が芽生えた」と主張するエンジニアを解雇https://t.co/YYJQ9rB0pP「人工知能が感情を持つようになった」 Blake Lemoineさん、解雇されていたのですね😶#Google #人工知能#ブログ仲間とつながりたい #ブロガーさんと繋がりたい #駆け出しエンジニアと繋がりたい,28,0,395,36,https://twitter.com/82tech/status/1552099794595696640,28
1551473576620032000,unibo_official,2022-07-25 07:45:00+00:00,おつかれさまです(【*0 ~ 0*】)ユニボです🤖✨今日は、#かき氷の日 ！🍧かき氷はヒヤッとおいしいって聞きました！ボクも食べてみたいデス🥄❄️#ユニボ #unibo #AI #ロボット #人工知能 #企業公式 #企業公式がお疲れ様を言い合う #イラスト  #Python #プログラミング #イマソラ https://t.co/8ZzrQr1KaU,17,0,143,1,https://twitter.com/unibo_official/status/1551473576620032000,17
1550844151062622208,UTAChem_OB_PRSK,2022-07-23 14:03:53+00:00,今日はがん患者の時間依存型ROC曲線を機械学習×生存時間解析のアンサンブルモデル使って自作するPythonコードを書いてました(生存ベースラインモデル)✨今のところ200行くらい😋#今日の積み上げ   #人工知能#駆け出しエンジニアと繋がりたい#勉強垢さんと繋がりたい#アニメ好きな人と繋がりたい https://t.co/46QdLVwibT,14,0,239,154,https://twitter.com/UTAChem_OB_PRSK/status/1550844151062622208,14
1550824073432670209,ai_gajumaru,2022-07-23 12:44:06+00:00,どのテーマにどの特徴量があると良いかは一概に言えないが、需要予想の場合は大抵過去実績が一番効く。#AI #機械学習 #人工知能,17,1,184,230,https://twitter.com/ai_gajumaru/status/1550824073432670209,18
1553995813419814912,Ai__135,2022-08-01 06:47:28+00:00,引用元にいいねください#自撮り界隈  #自発ください #自撮り界隈の人と繋がりたい #美男美女さんと繋がりたい #美男美女と繋がりたい #いいねした人全員フォローする #らぶりつで気になった方お迎え #自発ください #らぶりつください #1mmでもいいなと思ったらいいねいいねください https://t.co/RfTKKAkwIn,11,0,71,46,https://twitter.com/Ai__135/status/1553995813419814912,11
1553993480640557056,suneta_ai,2022-08-01 06:38:12+00:00,全力で正座待機‼️‼️(((((((((((((o(*ﾟ▽ﾟ*)o))))))))))))) https://t.co/HHRTDUWYWo,21,0,625,357,https://twitter.com/suneta_ai/status/1553993480640557056,21
1553992750198009856,natyos_leo,2022-08-01 06:35:18+00:00,私のTwitter家族:親: @BNG2022 @RooKooMooKoo配偶者: @NUBS_AI子ども: @yuiboribi @miyui_yuiyuivia https://t.co/72kHO4P0aC⠀ https://t.co/vJI0mqmIds,10,0,97,98,https://twitter.com/natyos_leo/status/1553992750198009856,10
1553989767385477122,shirokuro_ai,2022-08-01 06:23:26+00:00,ねむちゃんお誕生日おめでとうございます！！🎉🎉＃碧棺合歓誕生祭2022 https://t.co/P8yM0akLoN,12,2,532,499,https://twitter.com/shirokuro_ai/status/1553989767385477122,14
1553989402040627203,ai_sy1985,2022-08-01 06:21:59+00:00,半休だけど2週間ぶりの休み✨✨お先にビール頂きます🍺 https://t.co/8dTetj8pH3,27,0,734,599,https://twitter.com/ai_sy1985/status/1553989402040627203,27
1553989289691664384,ai_06080,2022-08-01 06:21:33+00:00,あつい... #リゼロ #エミリア #イラスト #絵描きさんと繋がりたい https://t.co/jY9wb507aa,28,5,113,121,https://twitter.com/ai_06080/status/1553989289691664384,33
1553988320727773185,ai_mana_0724_,2022-08-01 06:17:42+00:00,コロナ発症3日目の子供倦怠感、激しい咽頭痛何とか薬は飲め36.6℃に解熱薬を服用以外は飲水、飲食困難酸素はOK　ただ血圧が低いと思う82/57  78 大丈夫かな？#コロナを5類以下にしたら日本は破滅です #コロナ陽性 #コロナ自宅療養,13,6,788,844,https://twitter.com/ai_mana_0724_/status/1553988320727773185,19
1553987343509782528,payate1412,2022-08-01 06:13:49+00:00,AIボーナスえぐくて草 https://t.co/xBIrZjsiA2,13,0,844,837,https://twitter.com/payate1412/status/1553987343509782528,13
1553986018746896384,yukix_xyami,2022-08-01 06:08:33+00:00,AIに失望した(),13,0,840,794,https://twitter.com/yukix_xyami/status/1553986018746896384,13
1553985175490805760,aika_ai_110,2022-08-01 06:05:12+00:00,#絵描きさんと繋がりたい#絵描きさんとつながりたい #イラスト好きな人と繋がりたい 垢作りたてほやほやです🔁とかコメントとか中心に気になる人無言フォローします https://t.co/5xW6qJwX7a,12,0,5,14,https://twitter.com/aika_ai_110/status/1553985175490805760,12
1553985147615080448,kodomotoko_ai,2022-08-01 06:05:05+00:00,「よし！この本丸でもうまくやろう！」パッと見パライソメンバーだけど、相変わらず髭切江www中途半端にみんな衣装バラバラ。 https://t.co/YKdak2eag3,15,0,435,301,https://twitter.com/kodomotoko_ai/status/1553985147615080448,15
1553982784020303872,gorillajoker2,2022-08-01 05:55:41+00:00,Pvp in fallout76とAI絵をやったらこれクランベリー湿原、PA、Foカラーかな https://t.co/Lt4fo2mlxw,22,3,409,354,https://twitter.com/gorillajoker2/status/1553982784020303872,25
1553981527582683137,ai_shell,2022-08-01 05:50:42+00:00,nowのあいちゃん https://t.co/FoFkr0WFUC,10,1,324,189,https://twitter.com/ai_shell/status/1553981527582683137,11
1553980838051659776,kodomotoko_ai,2022-08-01 05:47:58+00:00,「日向正宗ぇぇぇぇ！！主！！早く！！！早く日向さんを箱から出して差し上げろぉぉぉぉ」日向が顕現しました！！良かったね、膝丸www https://t.co/IKMQ7oFBoy,15,1,435,301,https://twitter.com/kodomotoko_ai/status/1553980838051659776,16
1554000026208452609,H__and_his__B,2022-08-01 07:04:12+00:00,1. Sympa (入場)2. Slumberland3. Sorrows4. Vinyl5. McDonald Romance6. NIGHT POOL7. Hitman8. Don't stop the Clooks9. It's a small world10. Flash!!!!11. Tokyo Randez-Vouz12. Prayer X13. The hole14. サマーレインダイバーこれやりたい,15,0,734,768,https://twitter.com/H__and_his__B/status/1554000026208452609,15
1553997495436738562,luscaman_ito110,2022-08-01 06:54:09+00:00,#bayfm_it春原さん、今日もお疲れ様でした,11,0,239,332,https://twitter.com/luscaman_ito110/status/1553997495436738562,11
1553997492462637056,a26mt28,2022-08-01 06:54:08+00:00,今日も楽しい時間をありがとうございました(⁎ᴗ͈ˬᴗ͈⁎)また明日👋 #bayfm_it,12,0,88,83,https://twitter.com/a26mt28/status/1553997492462637056,12
1553997376503033858,ichigokekiki,2022-08-01 06:53:41+00:00,春原さんスタッフの皆さんイッターの皆さんお疲れ様でした😃今日も猛暑日の愛知県です🥵今月も暑さに負けずに、頑張ります💪面白い話題とミュージックをありがとうございました😆また、明日👋👋素敵な午後をお過ごしください🙆‍♂️ #bayfm_it   #bayfm #イマソラ https://t.co/Y3tQLOelOA,11,0,403,376,https://twitter.com/ichigokekiki/status/1553997376503033858,11
1553997297272651776,6keRET97jtLcpxJ,2022-08-01 06:53:22+00:00,春原さん、スタッフの皆様、イッターの皆様本日もありがとうございました😊また参加させて頂きますね🤗お疲れ様(*･ω･*)ゞﾃﾞｽ!!#bayfm_it,12,0,665,511,https://twitter.com/6keRET97jtLcpxJ/status/1553997297272651776,12
1553997271565762560,TBBgentsuki,2022-08-01 06:53:16+00:00,春さん、スタッフの皆さん、イッタ―の皆さん、お疲れさまでした‼また明日ー❣ #bayfm_it,14,0,572,525,https://twitter.com/TBBgentsuki/status/1553997271565762560,14
1553997248073453568,angeltears_0918,2022-08-01 06:53:10+00:00,春原さん、リスナーのみなさんお疲れ様でした！本当は今日成田のなごみの米屋にリベンジの予定だったのですが、イベント時にエコバッグ終了してしまったと😭　電話してよかった💦ダラダラとこの後も家の掃除を続けます🤣←外には出れぬ🥵#bayfm_it https://t.co/nKesgkJtBq,12,0,304,413,https://twitter.com/angeltears_0918/status/1553997248073453568,12
1553997211926597632,guguganmo_dessu,2022-08-01 06:53:01+00:00,春原さん、スタッフの皆さんイッターの皆さんありがとうございました✨外出先からでしたが、楽しく参加できました🎵またよろしくお願いします😊#bayfm_it,10,0,96,37,https://twitter.com/guguganmo_dessu/status/1553997211926597632,10
1553997081454399488,toshie_no_danna,2022-08-01 06:52:30+00:00,春原さん。お疲れ様でした😊また明日👋👋👋 #bayfm_it,10,0,115,165,https://twitter.com/toshie_no_danna/status/1553997081454399488,10
1553997048139378689,lamf1977,2022-08-01 06:52:22+00:00,久しぶりに3時のちゃーができて良かったです☺️春原さん、スタッフのみなさん、イッターのみなさん、ありがとうございました😊 #bayfm_it,10,0,255,304,https://twitter.com/lamf1977/status/1553997048139378689,10
1553996204245102592,____Uima,2022-08-01 06:49:01+00:00,・８月８日めっちゃ楽しみー！！隠れリクマユ🐿🐱💛💚息子とCLAP CLAPするぞーー👏🏻#NiziU #NiziUfanart#CLAP_CLAP #NiziU_Light_it_up #スッキリ @NiziU__official @ntv_sukkiri https://t.co/dBHl3Co05p,17,4,896,166,https://twitter.com/____Uima/status/1553996204245102592,21
1553988139638673409,the_real_nagia,2022-08-01 06:16:58+00:00,$2 instant tonkotsu-ish (とんこつ風) ramen!!! I think it came out great 😊🤤💜 https://t.co/N8ZBDTR1yG,16,0,717,553,https://twitter.com/the_real_nagia/status/1553988139638673409,16
1553985930964348928,bk_5_gira,2022-08-01 06:08:12+00:00,駅広告、見知らぬかわいいおじさんが映り込んでしまったー！！出来るだけ人が通らん柱選んだんやけどな〜😂😂😂ごめんなさいの気持ち🙏リベンジだ！！ #JO1 @official_jo1 #僕らの季節 / With Us / Move The Soul /  Walk It Like I Talk It / YOLO-konde / Algorithm/ ALL HOURS,10,11,666,742,https://twitter.com/bk_5_gira/status/1553985930964348928,21
1553985677947154432,mmhrissi530,2022-08-01 06:07:11+00:00,東京駅のまめちゃん🐶❤️はちゃめちゃにかわいすぎるし、サイネージのサイズ大きくて感動してる🥲❤️#豆原一成#andJO1_見つけて11STARS #JO1 @official_jo1 With Us Walk It Like I Talk It YOLO-konde Move The Soul Touch https://t.co/G0HFcgvimz,11,3,459,667,https://twitter.com/mmhrissi530/status/1553985677947154432,14
1553985674524692480,Ajisai45361845,2022-08-01 06:07:11+00:00,皆様おはようございます🤗8月ですねー！残り少ない夏を楽しまなくっちゃ！今週も皆様のツイ楽しみに読ませて頂きます！本日が皆様にとって良い週のスタートとなりますように🌻🌵✨☆✨It's August!Let's enjoy a short summer.🏖I wish you a good start to the week!#August https://t.co/QEs9U9Awiz,15,0,355,402,https://twitter.com/Ajisai45361845/status/1553985674524692480,15
1553985355988467713,luscaman_ito110,2022-08-01 06:05:55+00:00,#bayfm_it3時の茶ー https://t.co/KoQHRXSvOt,20,0,239,332,https://twitter.com/luscaman_ito110/status/1553985355988467713,20
1553985354209718272,bz_3811,2022-08-01 06:05:54+00:00,春さん､月曜イッターの皆さん､こんにちは🌤車の中で聴聴きながら､今帰宅しました。色々あって､これから…お昼食べとこうかな⁇3時の茶〜は､気持ちだけ一緒に😅今日から8月💦今月もよろしくお願いします😊💦 #bayfm_it,13,0,131,303,https://twitter.com/bz_3811/status/1553985354209718272,13
1553985157241393152,lamf1977,2022-08-01 06:05:07+00:00,少し遅れましたが、久しぶりの3時のちゃーです！きゅーけー&amp;お疲れ様です！ #bayfm_it https://t.co/Ky89rucviX,19,0,255,304,https://twitter.com/lamf1977/status/1553985157241393152,19
1553985126933344257,Girigiri_Tamatt,2022-08-01 06:05:00+00:00,３時のちゃ～今朝の空#bayfm_it https://t.co/ercY041AIU,16,0,544,533,https://twitter.com/Girigiri_Tamatt/status/1553985126933344257,16
1553984946112720896,hiro512581,2022-08-01 06:04:17+00:00,"性別：男年齢：35住所：関西身長：173体型：普通お酒：好き煙草：吸わない。喫煙者🆖学歴：大学院卒年収：1,400〜1,600職業：IT系会社の役員休日：不定期(自分で決める)趣味：音楽、旅行、グルメ#Twitter婚活  @konkatwit",12,2,98,133,https://twitter.com/hiro512581/status/1553984946112720896,14
1553984910347894786,fuyutuki1,2022-08-01 06:04:08+00:00,#bayfm_itとりあえず、麦茶補給してくっかぁ！！ https://t.co/C6oxrtP9io,20,0,667,480,https://twitter.com/fuyutuki1/status/1553984910347894786,20
1553984710560272385,gourmon,2022-08-01 06:03:21+00:00,ほうじ茶できゅ～け～ #bayfm_it,13,0,135,220,https://twitter.com/gourmon/status/1553984710560272385,13
1553984472462561281,lemonbarm16,2022-08-01 06:02:24+00:00,さんじのちゃーちゃー今日はお昼食べすぎたからお茶のみで休憩#bayfm_it,16,0,38,333,https://twitter.com/lemonbarm16/status/1553984472462561281,16
1553984432637616129,mao_me0w,2022-08-01 06:02:15+00:00,きゅけー！！あつかった！！#bayfm_it,12,0,72,218,https://twitter.com/mao_me0w/status/1553984432637616129,12
1553941367185108992,daizuka3,2022-08-01 03:11:07+00:00,Amazonはweb2.0の企業の代表格という感じですが、web3.0、web4.0・・・となっても圧倒的な体力（ある事業の失敗による多...#薬局#融資Amazon今後の戦略は医薬品販売と中小企業向け融資を解説#337@fp_sekine https://t.co/cjqROqvhBE #Voicy,15,0,118,401,https://twitter.com/daizuka3/status/1553941367185108992,15
1553937441190338561,shun01171,2022-08-01 02:55:31+00:00,GVAとしてNFT出しました！みなさんの少しでも役に立てばと思っています。NFTの発行に関連する記事もリリースしていくので、是非読んでみてください！Web3.０法務をリードするGVA法律事務所がOpenSeaで「法務記事NFT」を公開！ https://t.co/aEa5RQuJVL @PRTIMES_JPより,16,2,888,494,https://twitter.com/shun01171/status/1553937441190338561,18
1553777857255833600,enjoy_web3,2022-07-31 16:21:23+00:00,Web3.0を仕事にしたいと思い、Web3.0のエンジニアになろうと思います。それもこれも、多少は #STEPN のおかげです。最近の改悪はちょっときついけど、そのおかげでWeb3.0の仕事を目指すきっかけになりました。これからプログラミングがんばります！#駆け出しエンジニアと繋がりたい https://t.co/TYUiPiS9iR,19,1,59,25,https://twitter.com/enjoy_web3/status/1553777857255833600,20
1553742882192109568,dimenkm,2022-07-31 14:02:24+00:00,【 ANIM Park Guide(仮) Vol.1 】Discordを追いきれない #ANIMs の皆さまへ。ANIM の一週間をハイライトしました！WEB3.0のアニメスタジオがいよいよ始動ですね ✨ 力を合わせて盛り上げていきましょー！！ https://t.co/3vlBZYFBVF,88,29,573,572,https://twitter.com/dimenkm/status/1553742882192109568,117
1553597032560230400,NZ95706265,2022-07-31 04:22:51+00:00,来週幼稚園に行く息子のカバン選び！黄色のバックが気にいったらしい。やっぱりWEB3.0世代のカバンは違うね～😆 https://t.co/0dl4Lwt02d,11,0,539,685,https://twitter.com/NZ95706265/status/1553597032560230400,11
1553546087419392002,wata100514,2022-07-31 01:00:25+00:00,久々にLA🇺🇸今回は #nftexpoversela に参加してます。NFTゲーム、メタバースなどWEB3.0関連の最先端カンファレンスは日本の100歩先を行ってて勉強になりました😌eスポーツとの相性も当然良いけど、更に幅広げて面白いことができる😁✨ https://t.co/1rCqSGlUCy,12,0,158,156,https://twitter.com/wata100514/status/1553546087419392002,12
1553543294415929349,yuzuyu_987,2022-07-31 00:49:19+00:00,旦那さんの代わりにNFTイベントに参加しましたがうまく出来ず…悔しいー！😭でもWeb3.0に触れられてよかった☺️お祭り騒ぎで楽しかった🐰🤍嵐のチケット取るみたいな争奪戦でこういうの久しぶりだなと思いました笑,29,0,265,154,https://twitter.com/yuzuyu_987/status/1553543294415929349,29
1553327153689022464,f3622,2022-07-30 10:30:27+00:00,参政党・松田学代表と対談！積極財政 Web3.0について https://t.co/bxcEUnZmuv @YouTubeより玉木代表は分かっておられる陰謀論、反ワクなどの怪しい話題はなし！#たまきチャンネル,17,6,635,430,https://twitter.com/f3622/status/1553327153689022464,23
1553281342200496128,murakamyista,2022-07-30 07:28:25+00:00,Web3.0&amp;ブロックチェーンに興味ある方集合！in 都内8月2日(火) 20:30から開始します！参加者募集中ですので興味ある方はぜひお申し込みください！ https://t.co/b5laW1mUEr #ハッカー飯,11,3,585,617,https://twitter.com/murakamyista/status/1553281342200496128,14
1553222830044909568,morishi725,2022-07-30 03:35:54+00:00,情報対策　のあみ先生の動画共有　【１次試験出題予想 第二弾】試験で狙い目？！2022年ニュースなトピック【中小企業診断士】_第167回00:58  ❶Web3.006:10  ❷ブロックチェーン07:24  ❸メタバース08:02  ❹NFT12:46  ❺DAO14:30  これだけは覚えておこう！https://t.co/Tov9vIg042,15,0,898,913,https://twitter.com/morishi725/status/1553222830044909568,15
1553210174889832448,P5NSTE,2022-07-30 02:45:37+00:00,Sleep to Earn の Web3.0 アプリ #SleeFi の第1回AMAが開催されました。8/1から始まるβテストが楽しみです☺⬇️第1回SleeFi AMAまとめhttps://t.co/M8EiJs2zTk⬇️最新情報はDiscordでhttps://t.co/Kh0XpypFdv#SleepToEarn #Web3#NFT #Sleep2Earn#AVAX@Avalancheavax https://t.co/2B6kaBcd0F,16,11,702,1407,https://twitter.com/P5NSTE/status/1553210174889832448,27
1553202458544857089,rei_omusubi,2022-07-30 02:14:57+00:00,本日、14時からおむすびチャンネル @omusubi_fjc のエンジニア主催の『Web3.0、ブロックチェーン、仮想通貨に関連する技術講座』を開催します！エンジニア雑談 @ryu_san_1 さんのチャンネルから配信をする予定ですので、ぜひご覧ください。 https://t.co/ZeS7m57AvD,11,2,590,111,https://twitter.com/rei_omusubi/status/1553202458544857089,13
1553188945390751744,Shin_Engineer,2022-07-30 01:21:16+00:00,休日ということでUdemy割引クーポンデーです。1610円で価格設定しました。Web3技術に興味のある方はぜひ。クーポン有効期限は5日間です🧙‍♂️↓↓↓【Web3.0アプリ開発入門】ReactとSolidity言語で簡単ブロックチェーンWebアプリ開発を体験してみよう！https://t.co/Wkq0bNfNWf#udemycoupon https://t.co/xrKDBLUogI,14,0,685,8,https://twitter.com/Shin_Engineer/status/1553188945390751744,14
1553989830018641920,vetlanprogramer,2022-08-01 06:23:41+00:00,Railsなんてやっても東京の一部の地域でしか仕事に就けない。しかも高いレベルを要求される。正社員でも給料は安い。やめておいがほういい。Java C# Pythonがいい　求人は全国にあるし　給料も高い 34   #駆け出しエンジニアと繋がりたい,10,1,167,0,https://twitter.com/vetlanprogramer/status/1553989830018641920,11
1553948881196650496,NoticeperiodCom,2022-08-01 03:40:58+00:00,コロナ急増で今日から在宅要請☺️初めてのリモート、不思議な感じリモート繋がらない😢モニター映らない😢再起動、既に20分経っても終わらない💦でも通勤時間を学習に充てられる😇#RaiseTeck#Java#今日の積み上げ#BuildUp#学習記録#駆け出しエンジニアと繋がりたい#プログラミング初心者,12,0,96,80,https://twitter.com/NoticeperiodCom/status/1553948881196650496,12
1553947917903282177,_yochan__,2022-08-01 03:37:09+00:00,コロナ急増で今日から在宅要請☺️初めてのリモート、不思議な感じリモート繋がらない😢モニター映らない😢再起動、既に20分経っても終わらない💦でも通勤時間を学習に充てられる😇#RaiseTeck#Java#今日の積み上げ#BuildUp#学習記録#駆け出しエンジニアと繋がりたい#プログラミング初心者,16,0,297,118,https://twitter.com/_yochan__/status/1553947917903282177,16
1553939492767428608,kou08web,2022-08-01 03:03:40+00:00,"本日の学習アウトプットデータ型（箱のようなもの）Javaで使われるデータ型種類&gt;String,int,boolean,byte,short,long,float,double,char変数＞情報の出し入れを行える入れ物、書き換えが可能、名前を付与される＃駆け出しエンジニア＃駆け出しエンジニアと繋がりたい",11,0,29,13,https://twitter.com/kou08web/status/1553939492767428608,11
1553938644645269505,NGY_it_anken,2022-08-01 03:00:18+00:00,Instagramでも随時最新の案件情報を掲載しています💁‍♀️是非ご覧ください！https://t.co/ebWmhxn2W1#Java #GoogleTest #COBOL #SQL #転職#エンジニア転職  #駆け出しエンジニアと繋がりたい #企業公式相互フォロー #企業公式夏のフォロー祭り#SES営業#Twitter転職,13,1,503,512,https://twitter.com/NGY_it_anken/status/1553938644645269505,14
1553906263443922944,mee_gamin,2022-08-01 00:51:38+00:00,統合版とJava版どっちも持ってる人間になりました！！！！！,10,0,654,704,https://twitter.com/mee_gamin/status/1553906263443922944,10
1553895805932929030,kskses_upmills,2022-08-01 00:10:04+00:00,"今週の注力案件！■エンド直or元請け直・Ruby・Typescript/React,Vue,Angular・LinuxOS構築・C#・QNX/C++・Java/Spring・AWS営業人材で当てはまる方がいらっしゃいましたら、ぜひご紹介をお願いいたします！今月もよろしくお願いいたします！＃SES＃SES営業",14,0,711,575,https://twitter.com/kskses_upmills/status/1553895805932929030,14
1553892556802768896,M93147949,2022-07-31 23:57:10+00:00,日にち:7月31日今日の積み上げ:５時間🔹コーディングCSSの模写🔹progateのJava script模写の最後の写真と文章の横並びからの修正で他の部分も崩れてあれこれいじっていて気がついたら時間が何時間がすぎた！今夜もう一度トライします！#famm　5月卒業#webデザイン,13,0,79,82,https://twitter.com/M93147949/status/1553892556802768896,13
1553888288720707584,reading_earth,2022-07-31 23:40:12+00:00,#しゅきメモ#応用情報技術者試験#駆け出しエンジニアと繋がりたい EJB（Enterprise JavaBeans）JavaBeansをサーバサイドで実現する技術であり、javaのデータ保管庫（JavaBeans）という物（オブジェクト）をサーバサイドで実装する道具のようなもの,10,0,543,382,https://twitter.com/reading_earth/status/1553888288720707584,10
1553878959049551872,Kodomo10nature2,2022-07-31 23:03:08+00:00,#今日の積み上げ☑高配当株スクリーニング☑java勉強・トランスパレントPCが快適だと色々できるなぁ😍って何回呟いてるんだ🤣mac思ってた以上に良くてもうすっかり🍎の民🤣#携帯はAndroid,19,0,166,167,https://twitter.com/Kodomo10nature2/status/1553878959049551872,19
1553875645569982465,shake05200226,2022-07-31 22:49:58+00:00,おはしゃけ🐟今日も朝活から積み上げましょう#今日の積み上げ ①基本情報技術者試験②Salesforce学習③Java学習④Python学習8月も変わらず朝活積み上げます👍#プログラミング学習#駆け出しエンジニア#Python#Vue.js #spring#Java,13,0,669,268,https://twitter.com/shake05200226/status/1553875645569982465,13
1553860127266344960,hand0724,2022-07-31 21:48:18+00:00,エンジニア168日目オナ禁65日目Java silver模擬試験週間スタート！8/6の本番に向けて仕上げていきます！初日の今日は昨日のツーリングの疲れを取るために朝は休息します☺️火曜日の模擬試験までは、間違えた回数が多い問題を重点的に復習します！#駆け出しエンジニアと繋がりたい #オナ禁,17,0,82,30,https://twitter.com/hand0724/status/1553860127266344960,17
1553857790585606144,erimano23,2022-07-31 21:39:01+00:00,おはようございます。8月になり今週も始まりましたね。8月はお盆休みもあるので自習勉強も頑張らないとな。今日はJavaとJSの授業の予定。そして週の後半からPHPの授業も始まる。しっかりついていけるようにしていきたい。コツコツ続けよう。#プログラミング学習,12,0,185,203,https://twitter.com/erimano23/status/1553857790585606144,12
1553850108457783296,sirouto_java,2022-07-31 21:08:29+00:00,javaでコードの読み書きできるようになりたいけど練習問題解くより自分で作りたいアプリとか作るほうが身につきますか？？#駆け出しエンジニアと繋がりたい #ITエンジニア #プログラミング初心者と繋がりたい,15,0,20,28,https://twitter.com/sirouto_java/status/1553850108457783296,15
1553838223000223746,ryu_itkensa,2022-07-31 20:21:15+00:00,#朝活おはようございます☀[今日の学習]✔︎Java silver✔︎toeic AI問題今日も一日頑張っていきましょう📚,10,0,126,129,https://twitter.com/ryu_itkensa/status/1553838223000223746,10
1553774126422433792,st_infi,2022-07-31 16:06:34+00:00,JavaScriptのことを略して「Java」と表現したら、「全く別物だよ！たこ焼きとタコライスくらい違う」とご指摘をいただきました。お恥ずかしい。こういう細かな知識もきちんと付けていって、クライアントに信頼される制作者になりたいです。#Web制作,11,0,26,39,https://twitter.com/st_infi/status/1553774126422433792,11
1553764863712718848,_yochan__,2022-07-31 15:29:45+00:00,🌟2022.07.31💡やったこと《Python》エラー対応《YouTube》SpringBoot計: 1時間15分✍️感想夜になったけど、やっとWi-Fi繋がった🥺Pythonが遂に動いた😆#RaiseTech#Java#学習記録#今日の積み上げ#プログラミング初心者#駆け出しエンジニアと繋がりたい#転職#BuildUpDaily#Python,27,0,297,118,https://twitter.com/_yochan__/status/1553764863712718848,27
1553763269315563520,sax_Java_sparow,2022-07-31 15:23:25+00:00,#今月描いた絵を晒そう比較的！描いた！8月も描くぞー！多分描くぞー… https://t.co/rl9We3oN6v,10,2,184,120,https://twitter.com/sax_Java_sparow/status/1553763269315563520,12
1553741942441517058,AmaProgra,2022-07-31 13:58:40+00:00,友達から『PHP』と『java』の教材もらうツイートしたらネタだろって言われたので受け取った教材の証拠になります#駆け出しエンジニア #駆け出しエンジニアと繋がりたい https://t.co/outDYwFgcK,26,0,67,45,https://twitter.com/AmaProgra/status/1553741942441517058,26
1553738971678928896,KAZE_AMATSU,2022-07-31 13:46:52+00:00,Java silverの勉強してるけど、なんか思ってた感じとちょっと違うというか…こんなん知るか！みたいなひっかけ問題・豆知識が多くて、実務に活きるというよりはJavaそのものの知識が培われるだけのような…(それも大切なのはもちろんだけど)#駆け出しエンジニアと繋がりたい #駆け出しエンジニア,47,0,47,79,https://twitter.com/KAZE_AMATSU/status/1553738971678928896,47
1553736980558532610,engi_inve,2022-07-31 13:38:57+00:00,JavaSilverに合格できました！【合格までにやったこと】①YouTube視聴　 せかチャン　Java入門　1〜6章②黒本　1〜11章 2周③黒本　12.13章  3周①せかチャンhttps://t.co/IXLa3MMTor #駆け出しエンジニアと繋がりたい #プログラミング初心者 #プログラミング,15,1,74,47,https://twitter.com/engi_inve/status/1553736980558532610,16
1553734169964191744,hi_3_hi,2022-07-31 13:27:47+00:00,🙋🏻‍♂️Java！🙋🏻‍♂️Python！🙋🏻‍♂️Ruby！🙋🏻‍♂️C#！🙋🏻‍♂️HTMLのclass名「box」ってつけがちﾜﾛﾀ🙋🏻‍♂️🙋🏻‍♂️🙋🏻‍♂️🙋🏻‍♂️🙋🏻‍♂️ソースコードです！！👏🏻👏🏻👏🏻👏🏻👏🏻🙋🏻‍♂️今日はなに〜〜？？🙋🏻‍♂️エクセルでDX〜！(),31,1,326,298,https://twitter.com/hi_3_hi/status/1553734169964191744,32
1553722707409178626,zuruzurugottsu,2022-07-31 12:42:14+00:00,JAVA版を手に入れたので昨日プレに参加してきた～‼️偶然にもおらふくん見つけちゃって列に並んで写真をパシャリ📸サウナにも行って整って来ましたとさ✨8月の末、回れなかった所にも行こうと思います😊 #ドズル社ランド夏 https://t.co/TUaVEYqzW5,38,0,530,648,https://twitter.com/zuruzurugottsu/status/1553722707409178626,38
1553719484363395073,java_yoko2525,2022-07-31 12:29:26+00:00,水着持っていかなかったけど楽しかったです！帰って寝ます😪 https://t.co/FCBNfjBt6I,14,0,73,53,https://twitter.com/java_yoko2525/status/1553719484363395073,14
1553706062192455680,42TrOcc7g2UNpFT,2022-07-31 11:36:06+00:00,java script勉強してたら、会社からC#勉強してくれと言われました。うん、分からん😁また0から勉強だ！👍#プログラミング #Cシャープ #javascript https://t.co/TMATAkEGeh,10,0,80,61,https://twitter.com/42TrOcc7g2UNpFT/status/1553706062192455680,10
1553703698119168001,yuki122114,2022-07-31 11:26:42+00:00,昨日のプレオープン楽しかったな！写真撮って頂いた皆様、ありがとうございます💛Java版の操作に慣れず、挙動不審で怖がらせてしまった方、すみません…もっと練習します💦本オープンもこのスキンで、ネームタグもツイッターと同じですのでぐいぐい来てもらえると嬉しいです😘＃ドズル社ランド夏 https://t.co/IPpL4c8BSk,19,1,178,290,https://twitter.com/yuki122114/status/1553703698119168001,20
1553696102767263744,Chizuko1113,2022-07-31 10:56:31+00:00,ヌメロンアプリの実装でこれまた苦戦💦最初はランダムな数字を出すコードだけ書いて、getElementByIdやinnerHTMLは後でいいんかな❓ググるとJavaやPysonのも出て来ます😮‍💨 後はhtmlなしでjsのコードのみとか。書き方もバラバラ。こりゃ時間がかかりそうだなぁ😅💧#駆け出しエンジニアと繋がりたい,12,0,237,315,https://twitter.com/Chizuko1113/status/1553696102767263744,12
1553696066763034629,tip1t,2022-07-31 10:56:23+00:00,今日中にテックカレッジのコミュニティに「パターン別のITで稼ぐ方法」を投下します。プログラミングやITを身につけることで増える選択肢を可能な限り網羅し、詳しく解説します。興味ある人はプロフのリンクからJava教材を購入すると、コミュニティに参加できます。 #駆け出しエンジニアと繋がりたい,18,0,277,8,https://twitter.com/tip1t/status/1553696066763034629,18
1553692564322222080,Mocha09011,2022-07-31 10:42:28+00:00,無事合格の確認できた✅一安心！！久々にJavaやって楽しかったから、この流れでSilverの勉強したいけど、試験立て込んでるので一旦Javaはお休みします😭 https://t.co/dGDjdPvpbj https://t.co/eyThSohphg,16,0,228,293,https://twitter.com/Mocha09011/status/1553692564322222080,16
1553692181281800192,AmaProgra,2022-07-31 10:40:56+00:00,何か友達が【PHP】と【Java】の参考書を持ってきてくれるらしい今まではHTMLしかできなかったけど、レベルアップのきっかけになるかな？#駆け出しエンジニア#駆け出しエンジニアと繋がりたい,60,0,67,45,https://twitter.com/AmaProgra/status/1553692181281800192,60
1553982754538172416,sayuuwakaran,2022-08-01 05:55:34+00:00,ていうかさ、アルゴリズム体操とか悪質な詐欺だろ。「空気を入れますしゅっ！しゅっ！」じゃなくてもっと「a［mid］がkeyより小さい場合はa［mid］がkey以下か判断してもしそうならminをmid+1と同じ値にします」とか言えよ馬鹿が。,11,0,391,330,https://twitter.com/sayuuwakaran/status/1553982754538172416,11
1553940989831946242,ZNamihey,2022-08-01 03:09:37+00:00,BANや凍結で #ガーシー を押さえ込もうとすればするほど、話題になって、逆に晒されてるの草アルゴリズム(？)が「政治」ネタとして捉えているのは、さすが参議院議員ということですな😌#ロリ谷ただいま https://t.co/JTuQk9SrHQ,12,2,152,229,https://twitter.com/ZNamihey/status/1553940989831946242,14
1553930676654600192,yasuhito,2022-08-01 02:28:38+00:00,無料の量子コンピュータチュートリアル「量子位相推定」編を公開しました。ショアの量子因数分解など重要な量子アプリの多くは、この量子位相推定に縮約されます。というくらい大事なアルゴリズムの解説です。https://t.co/yTvceze2D7,17,5,901,94,https://twitter.com/yasuhito/status/1553930676654600192,22
1553923677619912704,LinnoRoomDesign,2022-08-01 02:00:49+00:00,ここ最近のイラストACの動きです。見づらいかもですが記録として。もし毎日投稿を続けていたら『私の中のピーク』から先も上がり続けていたのか、それともどちらにせよ初心者サービス的なアルゴリズムが終了して下がっていったのか。 https://t.co/uOoPFL21T0,14,0,497,659,https://twitter.com/LinnoRoomDesign/status/1553923677619912704,14
1553911688209977346,hl7wc8s,2022-08-01 01:13:11+00:00,猫好きなので、猫の画像をあげて下さってたら例外なくイイネ押してるんですけど、そのせいか猫が出てくる頻度が増えてる気がする。対して、犬はほぼ見ない。これは、そういうアルゴリズムなのか、士業に猫好きが多いのか？犬も好きなんだけどなあ。犬もくれ。,38,0,924,755,https://twitter.com/hl7wc8s/status/1553911688209977346,38
1553887581028376578,teech_black,2022-07-31 23:37:23+00:00,検索結果はGoogleのアルゴリズムで変動するから、順位が下落したときのために日頃から上位サイトをよく確認しておくことが大切。変動前後の検索結果を比較することでどの指標が重視されたのかわかるようになる。,13,0,846,1226,https://twitter.com/teech_black/status/1553887581028376578,13
1553837379676680192,rero_carnelian,2022-07-31 20:17:54+00:00,@mathlava これだと、真の最適解が判明した後でそれを辿ってるから、神託アルゴリズムとかになっとる気がする。実際の雷は真の最適解じゃなくて局所最適解を辿ってるんじゃないかって気がする。,81,13,761,999,https://twitter.com/rero_carnelian/status/1553837379676680192,94
1553747928933888001,nr7yt1,2022-07-31 14:22:28+00:00,「HIPHOPは元々声なき者のもの」「アルゴリズムより自分のリズム」「生き抜こう地球丸いうちは」 #PUNPEE,16,0,191,316,https://twitter.com/nr7yt1/status/1553747928933888001,16
1553724183019786240,tcu_nirou,2022-07-31 12:48:06+00:00,ちなみに俺がTwitter消してたのはアルゴリズムのために10日ほどガチ勉強してたからですもしこれで単位落としたら第3クオーターメイド服で登校します,20,8,0,0,https://twitter.com/tcu_nirou/status/1553724183019786240,28
1553710629235466240,miyamido8888rs,2022-07-31 11:54:15+00:00,さすがに何も更新がないのはYouTubeのアルゴリズム的にヤバイ為、奇跡的に清夏の髪飾り(+)が出た瞬間のショート動画アップしました🙇→https://t.co/z9KV64yAXJ恐らく音量高いですのでお気を付け下さい😂今日ドコモショップに行きましたら、店員男性さんがRSプレイヤーさんで盛り上がりました🤣 https://t.co/1mQXRrfxZN,13,1,768,287,https://twitter.com/miyamido8888rs/status/1553710629235466240,14
1553687044437999616,fP42b4TknN0sncl,2022-07-31 10:20:32+00:00,基本情報のアルゴリズム問題が全くと言っていいほどわかりません。攻略法はありますか？ #駆け出しエンジニアと繋がりたい,28,1,44,14,https://twitter.com/fP42b4TknN0sncl/status/1553687044437999616,29
1553677153694208001,jam88093523,2022-07-31 09:41:14+00:00,@QnlyQ アルゴリズム難しいですよねでもわかると何か面白そう(* ॑꒳ ॑* )急上昇はホームの左上の探索から見れますよだいぶ前に変わった時は私も迷いました(そういう事じゃなく…かな？),11,0,89,43,https://twitter.com/jam88093523/status/1553677153694208001,11
1553672119111655425,yasu_research,2022-07-31 09:21:13+00:00,YouTubeの競合リサーチを圧倒的に効率化する方法。サムネイルで興味が惹かれるかを確認→デザインでもライティングでも勝てそうならTTPでぶつける。たったこれだけ。無策で突っ込んで勝てるのは、アルゴリズムを超える魅力を持っている人だけ🔍 #YouTubeリサーチ,12,0,263,7,https://twitter.com/yasu_research/status/1553672119111655425,12
1553671846952062976,m_uzic_f,2022-07-31 09:20:08+00:00,後半ずっと泣いてた「アルゴリズムじゃなく自分のリズム」「生き抜こう地球丸いうちは」本当に尊敬してます大好きですPさんの夢のつづきを見させてもらえる幸せ噛み締めながら見てた🥲一生PUNPEEという人間のヘッズです今年も配信してくれてありがとうフジロック!!!#PUNPEE,33,3,138,372,https://twitter.com/m_uzic_f/status/1553671846952062976,36
1553669328603856896,WRGIMUbro,2022-07-31 09:10:08+00:00,課金アルゴリズムを元に戻したい自分（3週間目）　　　　　　　VS資源を買ってデメテルを育てたい自分ファイッ‼︎‼︎,14,1,149,117,https://twitter.com/WRGIMUbro/status/1553669328603856896,15
1553636541871730688,todoroki3cars,2022-07-31 06:59:51+00:00,アルゴリズム・・🧐公開して2年経ったYoutube動画が急激に伸びることってあるんやな～！作ってる #道路標識 の動画って同じようなのを作っている人を見ないからニッチな世界だとは思っていたけど。日本中を旅した先で撮影したものを誰かに見てもらえるとか本当うれしい☺️ https://t.co/u2Xr7FGbIv,33,1,502,268,https://twitter.com/todoroki3cars/status/1553636541871730688,34
1553755469419753473,Naoko705310,2022-07-31 14:52:25+00:00,学習110日目 (1h)✳️Codestep ストアサイト縦書き 模写今日も母を連れて観光へ。あまり学習時間が取れないので、方針変更してソースコードを見ながら模写。早くjQueryの実装やってみたいなー。#プログラミング独学#codestep,15,0,307,270,https://twitter.com/Naoko705310/status/1553755469419753473,15
1553734169964191744,hi_3_hi,2022-07-31 13:27:47+00:00,🙋🏻‍♂️Java！🙋🏻‍♂️Python！🙋🏻‍♂️Ruby！🙋🏻‍♂️C#！🙋🏻‍♂️HTMLのclass名「box」ってつけがちﾜﾛﾀ🙋🏻‍♂️🙋🏻‍♂️🙋🏻‍♂️🙋🏻‍♂️🙋🏻‍♂️ソースコードです！！👏🏻👏🏻👏🏻👏🏻👏🏻🙋🏻‍♂️今日はなに〜〜？？🙋🏻‍♂️エクセルでDX〜！(),31,1,326,298,https://twitter.com/hi_3_hi/status/1553734169964191744,32
1553733081307435008,tmokmss,2022-07-31 13:23:28+00:00,GitLabのPostgresスキーマ設計勘所　たしかにあの規模のウェブサービスでソースコード見えるやつ珍しいから、こういうのめちゃくちゃ参考になるなあhttps://t.co/Be9gDvfCPj,51,5,128,116,https://twitter.com/tmokmss/status/1553733081307435008,56
1553723280103972865,Takahashi_888,2022-07-31 12:44:31+00:00,紅魔郷はなんだかんだ言って20年前のゲームだからwindows10だとツール入れないともうまともに動かんからなあSteam配信しようにもソースコードがないみたいだからかなり厳しい,10,2,971,1010,https://twitter.com/Takahashi_888/status/1553723280103972865,12
1553657765264244736,nk_technest,2022-07-31 08:24:11+00:00,このところ #heroku でWebAPIを作ってしますが、なかなか苦戦しています😅今日はheroku postgresからpandasのread_sql()でデータベースをDataFrameに格納するところは成功😍あとは、herokuにソースコードをデプロイすればOKのはず・・・#今日の積み上げ#駆け出しエンジニアと繋がりたい,14,0,120,143,https://twitter.com/nk_technest/status/1553657765264244736,14
1553642513948614658,mura_prog,2022-07-31 07:23:35+00:00,必死に手本コードあまり見ずにデザインだけ見て模写で勉強してるけど、scssと CSS設計とか無視して自走してるから、ソースコードがカオスすぎて完成したら２度と手が加えられないファイルとなる笑#プログラミング勉強中 #エンジニアと繋がりたい #Web制作,16,0,124,143,https://twitter.com/mura_prog/status/1553642513948614658,16
1553622469444980736,opt_misc,2022-07-31 06:03:56+00:00,けんちょん著の AtCodeer 本を頂きました！解説もソースコードも記述が丁寧かつ洗練されていて、プログラミング未経験でもストレス無く読めると思います！ https://t.co/88DgnKc2SN,54,4,520,251,https://twitter.com/opt_misc/status/1553622469444980736,58
1553558742603792384,Kentasan_7,2022-07-31 01:50:42+00:00,SIerいても技術力(プログラミング)つかないと言われてるが部署によるというのはある。パッケージ開発系だと担当レベルだとバリバリコード書くし、偉くなったら自分で実装せず外注するけどソースレビューはするし、コードに触れる機会は多い。レビューなんてプログラム読めないと全然できんよ,12,0,230,199,https://twitter.com/Kentasan_7/status/1553558742603792384,12
1553470389161840644,hospom,2022-07-30 19:59:37+00:00,あのさ、「正式な手続きを踏んで公で話す」責任があるのはViviさんではなくO氏なんだよ。なんせ10か月も前に公に宣言した「近日中にソースコード公開予定です」をまだ履行してないんだよ？いい加減あのSNSがマトモでないという目の前の現実を認めましょう。 https://t.co/E58J1KVWs1,20,4,0,0,https://twitter.com/hospom/status/1553470389161840644,24
1553442049436688384,sa20220430,2022-07-30 18:07:00+00:00,day91 終了Twitter Clone開発 lesson15 さくらVPSの mySQLと Twitter cloneのソースコード展開まで完了。ただ設定したIPアドレスでweb画面を確認すると403エラーで表示されなかったため明日apacheの再確認。＃テックアイエス #プログラミング初心者,11,0,45,28,https://twitter.com/sa20220430/status/1553442049436688384,11
1553376197119070209,kohei14172907,2022-07-30 13:45:20+00:00,製造業の派生開発の組込ソフトウェアを手掛けてるんだけど、他の会社はどのくらいソースコードを各機種で共通にしてますか？うちの会社では「派生機種のROMファイルを全て共通にすることを目指せ」って言われてて、「普通に無理じゃね？」って思ってます。,39,7,78,329,https://twitter.com/kohei14172907/status/1553376197119070209,46
1553344521777205250,e__WebAnimation,2022-07-30 11:39:28+00:00,／JavaScriptの2D描写ライブラリである「PixiJS」のフィルター機能を使用して画像の色を変更させるプログラムを作成してみましたあああ！！！📢＼表現の幅が広がりそうですね～🧙‍♂️https://t.co/0A4cW1BwlG👆ソースコードはこちらから覗けるよ👀#PixiJS #JavaScript #codolife https://t.co/YieCXroA5K,10,1,766,132,https://twitter.com/e__WebAnimation/status/1553344521777205250,11
1553301640916402176,takeo_webENG,2022-07-30 08:49:04+00:00,プログラミングで求めるられるものは、論理的思考力:=プログラムの挙動をソースコードを根拠に理解・説明できる力だと思います。それを学生時分で身につけていてよかったと感じますね#駆け出しエンジニア #プログラミング初心者 #転職 #Web制作,18,0,198,140,https://twitter.com/takeo_webENG/status/1553301640916402176,18
1553263749854679041,noeu611,2022-07-30 06:18:30+00:00,MSX-DOSもってないけどNEXTORというのを見つけてちゃんと動いた！MSX-DOSのソースコードを広範囲に使用しているものの、西さんに許可をもらってオープンソースになっているhttps://t.co/eWWhhlyGqc,94,27,63,118,https://twitter.com/noeu611/status/1553263749854679041,121
1553261988201234432,koyan_100,2022-07-30 06:11:30+00:00,さっきサイト修正依頼があったんだけど、話を聞いたら駆け出しフリーランスに作ってもらって公開したら連絡取れないらしい。おいおい、作ったら終わりかよ。それにしても汚いソースコードで理解するまで時間かかる・・。 #駆け出しエンジニアと繋がりたい,22,1,795,1022,https://twitter.com/koyan_100/status/1553261988201234432,23
1553130748344950784,ShoTakaNet1,2022-07-29 21:30:00+00:00,泥棒が嫌がるのは防犯カメラと犬の鳴き声だそうで、「防犯カメラに反応があったら犬の鳴き声をスピーカーから流す」という警戒システムを作った人が、ソースコードを公開しています。システムはRaspberry Piとスピーカー、カメラで構成され、正面と裏口にセットします。https://t.co/ErVXnmCTKa,18,15,303,200,https://twitter.com/ShoTakaNet1/status/1553130748344950784,33
1553056279257419776,wsyhawk,2022-07-29 16:34:06+00:00,お勧め #vscode 拡張 「GitLens」導入するとソースコード横にコミット者氏名やコミットメッセージが表示されbitbucketなどのコミットに飛ぶこともでき、git blame 的なことが視覚的にできる。バグ原因のコード横の氏名を見ると犯人が・・・真実はいつもひとつ🕵🏻‍♀️犯人が自分の時はYouってでるよ🥹ｗ https://t.co/DORX3p78vC,17,3,53,38,https://twitter.com/wsyhawk/status/1553056279257419776,20
1553038002653319168,blanc_7711,2022-07-29 15:21:28+00:00,#今日の積み上げ メモ✅侍教材のHTML/CSSの復習昨日からCSS学習中。CSSを知ることで、ホームページのソースがなんとなく読めるようになってきた。時間ができるといろんなホームページのコードを打ってみたり♪#駆け出しエンジニア#駆け出しエンジニアと繋がりたい#侍エンジニア#侍テラコヤ,12,0,20,11,https://twitter.com/blanc_7711/status/1553038002653319168,12
1553035894927822849,0Gl6dRrCzULm4Cm,2022-07-29 15:13:06+00:00,今日の積み上げ･Pythonの勉強･ソースコード作成仕事で疲れすぎて目の焦点が合わないw久しぶりに勉強出来て良かった！#プログラミング#プログラミング勉強#エンジニアと繋がりたい,17,0,117,141,https://twitter.com/0Gl6dRrCzULm4Cm/status/1553035894927822849,17
1553035743726931970,himazin_bivar,2022-07-29 15:12:29+00:00,ノーコードで書いたデザインとjsをlaravelにソースファイル置けたら楽だなと思ったけどノーコードで書いてノーコードのままで良くないから意味なかった#駆け出しエンジニアと繋がりたい,12,0,214,77,https://twitter.com/himazin_bivar/status/1553035743726931970,12
1553003924298559489,june19312,2022-07-29 13:06:03+00:00,PAST本は私のバイブルで、著者であるkenkooooさんのことも大変に尊敬しているのだが、今日の精進中、kenkooooさんはソースコードに祈りを込めて仏像を建立することがあるという逸話に遭遇し、この人はやっぱスゲエ！超リスペクト！という気持ちを深めた…（ABC198D問題、はまやんさんの解説より） https://t.co/nio89oOUU1,25,2,196,143,https://twitter.com/june19312/status/1553003924298559489,27
1552940240167325697,82tech,2022-07-29 08:53:00+00:00,🔽 GitHub、新しくなった「GitHub Projects」の提供を開始https://t.co/KEeGZnfllC簡単な開発プロジェクトの管理であれば、GitHubで完結させられそうですね👨🏻‍💻✅チケット管理✅ソースコード管理✅ワークフロー管理一元管理✨#GitHub #プログラミング #駆け出しエンジニアと繋がりたい,18,0,395,36,https://twitter.com/82tech/status/1552940240167325697,18
1552841814214070273,a_ya_pg,2022-07-29 02:21:53+00:00,エラーもなく、ただ動かないのって、エラー祭りよりしんどい…。ソースコードを動的に挿入して動かしてるから、順に追うのもめんどい…。昔々、開発者ツールなんて存在しないIE6と格闘した古のエンジニアたちは、アラートやらログやらで地道に足跡をたどったものですが、やりますか…。,12,1,278,258,https://twitter.com/a_ya_pg/status/1552841814214070273,13
1552700828095578113,Picnicer,2022-07-28 17:01:39+00:00,@igz0 コードレビューの結果、・正規表現利用禁止・三項条件演算式利用禁止・LINQ利用禁止・クラス作成禁止・メソッドの作成禁止・好きな変数名は利用できず暗号みたいな共通の名前しか使えず・レビュー時にエディタ禁止(excelにソースを添付必須)これが一般的な日本のコードレビュー☺️,35,21,184,188,https://twitter.com/Picnicer/status/1552700828095578113,56
1552653329452666881,em_webcreative,2022-07-28 13:52:55+00:00,学習 31日目。✔️復習・ソースコード整理✔️ポートフォリオカスタマイズ昨日、総復習を終えたのですぐ次に進もうと思ですが、今回学んだことを使いまわせるように保存したり、ポートフォリオに入れたり、アウトプットの日に。というと聞こえがいいですがちょっと休息日です😁#web制作#デイトラ,14,0,42,17,https://twitter.com/em_webcreative/status/1552653329452666881,14
1553970008270991360,UTAChem_OB_PRSK,2022-08-01 05:04:55+00:00,SQLite使うとPythonでSQLがお手軽に使えるけど、個人的にBigQueryとかAWS RedShiftの方がいいなとは思った🙃#今日の積み上げ  #駆け出しエンジニアと繋がりたい#勉強垢さんと繋がりたい#アニメ好きな人と繋がりたい https://t.co/Ac3DoYjqxB,18,0,239,154,https://twitter.com/UTAChem_OB_PRSK/status/1553970008270991360,18
1553953669149855744,beyomaru_ch,2022-08-01 04:00:00+00:00,新しい動画をアップしました🎉#AWS #Fargate #プログラミング初心者 @yktr_sreAWS Fargateについて現役エンジニアが解説します！是非ご覧下さい🙌https://t.co/ARLXuH5ATR,11,1,46,45,https://twitter.com/beyomaru_ch/status/1553953669149855744,12
1553949333212790784,mkb_hayano,2022-08-01 03:42:46+00:00,今日から8月ですねー何か始めるにも、辞めるにもちょうど良いですね。自分は、・情報処理安全確保支援士勉強・LPIC2勉強・AWS勉強に絞る月かなと。他にもたくさんやりたいことあるけれど、8月は辞めておきます。,12,0,151,151,https://twitter.com/mkb_hayano/status/1553949333212790784,12
1553947851817828352,yshd,2022-08-01 03:36:53+00:00,今年のPrime Dayのインフラ部分についてまとまってます！SQSで毎秒7050万メッセージを処理、は凄まじいですねｗhttps://t.co/S0dBVqE57N,64,19,535,420,https://twitter.com/yshd/status/1553947851817828352,83
1553929602774364161,tenshokusitai7,2022-08-01 02:24:22+00:00,今日から有給消化期間なので、朝からAWSクラウドプラクティショナーの勉強してます！8/13まであと2週間頑張ろう…！！#AWS,14,0,566,534,https://twitter.com/tenshokusitai7/status/1553929602774364161,14
1553900691218890755,Charlie_study,2022-08-01 00:29:29+00:00,【保有資格】・世界遺産検定2級・山の知識検定シルバー・AWS SAA・AWS クラウドプラクティショナー※城郭検定、歴史能力検定:取得目指してるWebライターで上の資格活かせるのか…😂 #Webライター  #webライターと繋がりたい,12,0,99,72,https://twitter.com/Charlie_study/status/1553900691218890755,12
1553896071545651200,AWS_course,2022-08-01 00:11:08+00:00,AWS Network Firewallにて、コインマイニングの脅威から保護する侵入検知および防止のルールを有効にできるようになりました。気づかないうちに、暗号通貨を掘られるリスクが減るとよいですね！#駆け出しエンジニアと繋がりたい #AWS #AWS認定 #暗号通貨 ＃ビットコイン https://t.co/e8e2aOcUm8,10,0,148,157,https://twitter.com/AWS_course/status/1553896071545651200,10
1553895805932929030,kskses_upmills,2022-08-01 00:10:04+00:00,"今週の注力案件！■エンド直or元請け直・Ruby・Typescript/React,Vue,Angular・LinuxOS構築・C#・QNX/C++・Java/Spring・AWS営業人材で当てはまる方がいらっしゃいましたら、ぜひご紹介をお願いいたします！今月もよろしくお願いいたします！＃SES＃SES営業",14,0,711,575,https://twitter.com/kskses_upmills/status/1553895805932929030,14
1553890214573391872,tsukamoto,2022-07-31 23:47:51+00:00,どこかの銀行の偉い人が「コードを書けないトレーダーは絶滅する」とまで言ってたけど、実際にそこと仕事するとコード書く人とかAWS組む人とかガチ勢がちゃんと出てくるというのが僕の周りの共通認識。IT利用企業が既にそうなのに、IT提供企業が自前で書かない文化だったら絶滅してそうだけど。 https://t.co/xxcwBhNhVd,11,3,881,712,https://twitter.com/tsukamoto/status/1553890214573391872,14
1553884691232849920,matg31,2022-07-31 23:25:54+00:00,AWSのセキュリティイベントre:Inforce2022の動画が公開されております。118本の動画があるのでこれを全部見て感想文かけば夏休みの宿題は完璧です（嘘https://t.co/epKQRx2FyH,127,29,455,917,https://twitter.com/matg31/status/1553884691232849920,156
1553879518003138563,0614d_suke,2022-07-31 23:05:21+00:00,おはようございます！☀️ #今日の積み上げ･会社行く今週もながい1週間がはじまった🫠 #駆け出しエンジニアと繋がりたい #Webエンジニア #プログラミング初心者 #AWS  #JavaScript  #Vue,26,0,383,177,https://twitter.com/0614d_suke/status/1553879518003138563,26
1553879104117620736,puchimamepan,2022-07-31 23:03:42+00:00,@aws_official どの世界もお母さんは大変ですね。そして優しい💓,12,0,216,197,https://twitter.com/puchimamepan/status/1553879104117620736,12
1553877564833546241,takeshi__1016,2022-07-31 22:57:35+00:00,今日も学習頑張ります！AWSSQL基本情報技術者#プログラミング勉強中 #プログラミング初学者 #プログラミング初心者と繋がりたい,12,0,726,708,https://twitter.com/takeshi__1016/status/1553877564833546241,12
1553871384312369152,kyooooonaka,2022-07-31 22:33:02+00:00,おはようございます。今週も頑張っていきましょう。今日はELBとAuto Scalingについて調べて理解していこうと思います。#AWS #AWS認定 #エンジニアと繋がりたい #駆け出しエンジニアと繋がりたい,19,1,210,266,https://twitter.com/kyooooonaka/status/1553871384312369152,20
1553773684304670720,RagWork,2022-07-31 16:04:48+00:00,@ebiebi_pg だいたいこんな理由・オンプレ買うと5年一括の固定資産になるけどクラウドだと1年の経費になる・基本的に壊れない。サービス止まったらだいたいAWSのせい・ハードウェアの障害対応しなくていい・困ったときはまずクラスメソッドのブログを読め,31,7,171,468,https://twitter.com/RagWork/status/1553773684304670720,38
1553761420457943041,5m0_zx,2022-07-31 15:16:04+00:00,Linuxとミドルウェア書き連ねるよりAWSの一言で採用出しやすい？ https://t.co/IUPcoSb6Y2,16,2,493,1895,https://twitter.com/5m0_zx/status/1553761420457943041,18
1553758252852445184,masaosaan,2022-07-31 15:03:29+00:00,#AWSDevDay 2022 のCFP 募集開始します!!今年は11/8~10に開催です。CFP の締め切りは8月 21 日 23:59!! どしどしご応募待ってます!!!!https://t.co/Cj878dpHsi,48,23,913,477,https://twitter.com/masaosaan/status/1553758252852445184,71
1553753808349855745,coosuke,2022-07-31 14:45:49+00:00,相変わらずAWSへ転職する大先輩が多い,10,0,578,689,https://twitter.com/coosuke/status/1553753808349855745,10
1553749351243337728,gintsubasa,2022-07-31 14:28:07+00:00,@ebiebi_pg 真面目に考えるて、AWSみたいな冗長性を日本の企業のインフラで謳おうとすると、めちゃくちゃ金がかかるってところがポイントになりそうAWSがSLAを担保できるかという話は置いといて,30,2,154,218,https://twitter.com/gintsubasa/status/1553749351243337728,32
1553744733230743554,tomokn5,2022-07-31 14:09:46+00:00,HTML「楽しい」Ruby・Python「楽しい」Javascript「超楽しい」AWS・Docker・CircleCI「辛いけどエラーを解決したときの達成感がすごい」CSS「辛い」#駆け出しエンジニアと繋がりたい,14,0,61,75,https://twitter.com/tomokn5/status/1553744733230743554,14
1553739326097616896,kizawa2020,2022-07-31 13:48:17+00:00,我が家ではAmazon＝通販としか認知されていないので、AWSの資格たくさん取得したり表彰されたとしても「お買い物券は貰えないの？ なんだつまらない」と一蹴されて終わるという現実。,63,14,768,629,https://twitter.com/kizawa2020/status/1553739326097616896,77
1553729843811852288,i9SaIC2QmqxYBJK,2022-07-31 13:10:36+00:00,#今日の積み上げ メモ✅LaravelLaravelはPHPより環境構築が大変😇さらにコマンド操作とAWSのCloud9の操作が慣れてないことも相まって大苦戦😇すでに心バキバキw,12,1,97,143,https://twitter.com/i9SaIC2QmqxYBJK/status/1553729843811852288,13
1553727140746539009,Jix7M5,2022-07-31 12:59:51+00:00,"●今日の内容顔認証システムの構築　ROS,AWS,Python,Linux最高でした。普段の顔認証の裏側が知れて勉強なった。転職してからも活かしていきたい#駆け出しエンジニアと繋がりたい #プログラミング初心者 #転職",22,0,107,167,https://twitter.com/Jix7M5/status/1553727140746539009,22
1553716533851230214,aws_TakS07,2022-07-31 12:17:42+00:00,両親に少し遅めの誕生日祝いをしてもらいました。これからは自分が両親を支えていく立場なので引き続き頑張ります。 https://t.co/WNbnx5ev7M,18,0,897,286,https://twitter.com/aws_TakS07/status/1553716533851230214,18
1553952244042592257,snail_910,2022-08-01 03:54:20+00:00,【プログラミング学習のProgate】Gitのレベルが9にUPしました！ https://t.co/Ak5uZtpy1P #Progate git直前予習してないことに気づいて少し慌ててやっている。。,18,2,108,100,https://twitter.com/snail_910/status/1553952244042592257,20
1553940255321227264,sBu5JmF34Xhe2aM,2022-08-01 03:06:42+00:00,#今日の目標勉強する　先週のダメージがでかいので、法令を見るかGitにて構成・コードの続き見る#医療事務 #python #駆け出しエンジニアと繋がりたい#プログラミング初心者と繋がりたい #coding #programming #pythonlearning,20,1,56,21,https://twitter.com/sBu5JmF34Xhe2aM/status/1553940255321227264,21
1553897329744564225,mr_trj0507,2022-08-01 00:16:08+00:00,✅案件対応ここ最近の案件で、git、ejs、バニラJS、FLOCSSを実践で使いこなせるようになった。ある程度の基礎知識がついたら、あとは実践の中で使っていくのが一番早く覚えらて、他でも使える知識に変わってる。#駆け出しエンジニアと繋がりたい,10,0,79,51,https://twitter.com/mr_trj0507/status/1553897329744564225,10
1553886733724680192,2021_kitten,2022-07-31 23:34:01+00:00,今回はここまでにしておきます。次回は「#03 gitの設定をしよう」からの予定です。#dotinstall#プログラミング#駆け出しエンジニアと繋がりたい#フォロバ100,12,0,903,643,https://twitter.com/2021_kitten/status/1553886733724680192,12
1553872605815668736,hedway19,2022-07-31 22:37:53+00:00,8月の行動計画☕️□ 案件フルコミット□ 営業200件（未来への種まき）□ 7期生向け宿題（目的目標の再確認）□ 収入は自己投資→コーディング力向上に□ Git / Github学習（スキル向上）□ 毎日　最低1ツイート継続□ 毎日　行動日報継続今月も頑張りましょー😊#web制作#codolife,14,0,384,351,https://twitter.com/hedway19/status/1553872605815668736,14
1553870927246786560,kiko_kiko0207,2022-07-31 22:31:13+00:00,"【今日の積み上げ/独習初級2日目(2週目)】・PC, SPコーディング完了させる・Gitの使い方勉強2回目なので今日でhtml,css完了するように頑張ります🙌午後からは引き続きGitの本をみながら少し勉強🧐#テックアカデミー #はじめての副業コース#駆け出しエンジニアと繋がりたい",12,1,73,42,https://twitter.com/kiko_kiko0207/status/1553870927246786560,13
1553762170722086912,yz_ctrn,2022-07-31 15:19:03+00:00,#今日の積み上げ💻 #ドットインストール git入門14〜22#デイトラ #webデザイン 中級編Day13〜20(コーポレートサイト作成)🇮🇹 Dropsgitむずかしいよーーー😂😂,15,0,57,190,https://twitter.com/yz_ctrn/status/1553762170722086912,15
1553745163633426435,vTz4E20oLLV1Mp7,2022-07-31 14:11:28+00:00,今日の勉強時間　10時間勉強内容gitの基本操作dockerの基本操作イメージのビルドコンテナの作成＃駆け出しエンジニアと繋がりたい,12,0,34,27,https://twitter.com/vTz4E20oLLV1Mp7/status/1553745163633426435,12
1553743526394937344,KengoKonishi,2022-07-31 14:04:58+00:00,"git commitする時にコミットメッセージ残す時に、勢い余って保存しちゃった場合はgit commit --amend -m "" ""で変更可能。備忘メモ。＃駆け出しエンジニアと繋がりたい　#プログラミング初心者と繋がりたい",19,0,50,35,https://twitter.com/KengoKonishi/status/1553743526394937344,19
1553741273244508160,TK_to_engineer,2022-07-31 13:56:01+00:00,"day8・独学エンジニアtoday:4htotal:31hGit,GitHubの登録、VScodeの環境構築などの下準備をした！ターミナルのコマンドも勉強！ターミナルでのGit、homebrewインストールでエラーが出たからトラブルシュートせねば…#未経験エンジニア#駆け出しエンジニアと繋がりたい",13,0,21,71,https://twitter.com/TK_to_engineer/status/1553741273244508160,13
1553738385743028227,nobushoshin,2022-07-31 13:44:32+00:00,Gitをインストールしてみました。#cs50 の動画と #Progate を参考にして無事にインストール、GitHubへのpushも試し成功しました😄まだ個人で勉強中ですが、コード履歴管理などGitを使う練習もしていく予定です😎https://t.co/4py9JC2erQ#プログラミング初心者,11,0,85,35,https://twitter.com/nobushoshin/status/1553738385743028227,11
1553724001951707136,ooooonse0524,2022-07-31 12:47:23+00:00,■7月31日学習時間：6.5H・RUNTEQ課題（Ruby基礎）・EverydayRails（P82まで）・Gitの知識整理（Notion途中）など■8月1日(目標)・RUNTEQ課題（Ruby基礎）・EverydayRails・アプリ③設計　などもう寝るし！！😇#RUNTEQ  #1000時間チャレンジ,15,0,132,115,https://twitter.com/ooooonse0524/status/1553724001951707136,15
1553655240921997314,Tsuchi_AE,2022-07-31 08:14:09+00:00,所持gitが3億越えた https://t.co/MOoL5JoTAr,22,0,273,249,https://twitter.com/Tsuchi_AE/status/1553655240921997314,22
1553567298467663872,OK4P88Mj8jJqYcl,2022-07-31 02:24:42+00:00,「Git 学習レッスン I」レッスンを修了しました！ https://t.co/tmexgUuoJL #Progate #今日の積み上げ#50代からのプログラミング#プログラミング初心者#テックアイエス#progate,19,0,38,31,https://twitter.com/OK4P88Mj8jJqYcl/status/1553567298467663872,19
1553560658335019008,git_mifu,2022-07-31 01:58:19+00:00,mifu㊙︎情報正直これだけでもいいと思っている https://t.co/MIrLngJj5D,10,1,183,445,https://twitter.com/git_mifu/status/1553560658335019008,11
1553525090922668032,kiko_kiko0207,2022-07-30 23:36:59+00:00,【今日の積み上げ/独習初級1日目(2週目)】・PC版コーディング半分完成・Gitの使い方勉強初級だけ復習のためにもう1度挑戦します！午後からは実務に向けて購入したGitの本をみながら少し勉強🧐#テックアカデミー #はじめての副業コース#駆け出しエンジニアと繋がりたい,31,0,73,42,https://twitter.com/kiko_kiko0207/status/1553525090922668032,31
1553514817423835136,atuo_39,2022-07-30 22:56:10+00:00,いつでもおはようさん☕️#今日の積み上げ・Git・音声学習以上をしていきます朝活→2h今日もデイトラの動画視聴していきます！#codebegin  #デイトラ  #しめサポ #朝活,12,0,194,288,https://twitter.com/atuo_39/status/1553514817423835136,12
1553513629882134529,gigagent,2022-07-30 22:51:26+00:00,Git&amp;GitHubUNIXとDBMS操作したことある人にとっては多分、簡単！#駆け出しエンジニアと繋がりたい #朝活 #モーニング #独学エンジニア #独学#読書好きな人と繋がりたい #プログラミング初心者と繋がりたい #プログラミング勉強中 https://t.co/9EYcEBqJ1U,18,0,64,154,https://twitter.com/gigagent/status/1553513629882134529,18
1553507464779145216,sBu5JmF34Xhe2aM,2022-07-30 22:26:57+00:00,#今日の目標勉強する　Gitにて構成・コード見る#医療事務 #python #駆け出しエンジニアと繋がりたい#プログラミング初心者と繋がりたい #coding #programming #pythonlearning,24,1,56,21,https://twitter.com/sBu5JmF34Xhe2aM/status/1553507464779145216,25
1553506576283025408,PysBuh,2022-07-30 22:23:25+00:00,○変更履歴の確認コマンド・git logすべて表示・git log --online一行で表示・git log -p 〈ファイル名〉ファイルの変更差分だけ表示・git log -h〈コミット数〉表示するコミットの制限#今日の積み上げ#独学エンジニア#駆け出しエンジニアと繋がりたい,16,1,222,188,https://twitter.com/PysBuh/status/1553506576283025408,17
1553505354884861952,PysBuh,2022-07-30 22:18:33+00:00,○変更差分の確認コマンド・git diffgit addする前の変更分を確認ワークツリーとステージでの変更差分が表示される・git diff --stagedgit addした後の変更分ステージとリポジトリの変更差分が表示される#今日の積み上げ#独学エンジニア#駆け出しエンジニアと繋がりたい,19,1,222,188,https://twitter.com/PysBuh/status/1553505354884861952,20
1553504074447761408,PysBuh,2022-07-30 22:13:28+00:00,今日で朝活153日目でした✨・独学エンジニア2時間gitのコマンドの学習。変更状況の確認・変更履歴の確認について😊#今日の積み上げ#独学エンジニア#駆け出しエンジニアと繋がりたい,14,0,222,188,https://twitter.com/PysBuh/status/1553504074447761408,14
1553502444859969536,YupparW,2022-07-30 22:07:00+00:00,#GitとGitHubの教科書どういうものか知りたいだけなので読むだけにしようと思ったけど、むっちゃ便利そうだし説明わかりやすいのでとりあえず本に従って「Sourceree」をインストールしました🙌Git 使ってみます☺️#Web制作 https://t.co/ubWyc6zv0n,14,0,717,251,https://twitter.com/YupparW/status/1553502444859969536,14
1553499676749565952,daisuke_web0907,2022-07-30 21:56:00+00:00,インプットは朝に限る🤤・頭スッキリしてる・メールと電話がこない・前向きになれるメリットしかないなぁさーGitとアジャイル開発の勉強するぞーーーあ、子ども起きてきt,17,0,342,410,https://twitter.com/daisuke_web0907/status/1553499676749565952,17
1553411103245275136,Naoko705310,2022-07-30 16:04:02+00:00,"学習109日目 (1h)✳️Codestep ストアサイト　縦書きた・・・縦書きが難しい。。余白の付け方とか、方向がどっちだか分からなくなる〜😂相変わらずノロノロと進んでいますが、書店で取り寄せていた、jQuery, Sass, Gitの本が届いたので嬉しい。少しずつ読む。#プログラミング独学#codestep",18,0,307,270,https://twitter.com/Naoko705310/status/1553411103245275136,18
1553409706810413057,yz_ctrn,2022-07-30 15:58:29+00:00,#今日の積み上げ💻 #ドットインストール jQuery入門1〜13、git入門1〜13#デイトラ #webデザイン 中級編Day13〜20(コーポレートサイト作成)🇮🇹 Dropsその他 書類整理7月中に終わらせようと思ってたことが大体終わってよかった👌,34,0,57,190,https://twitter.com/yz_ctrn/status/1553409706810413057,34
1553409388152442881,rightlight_web,2022-07-30 15:57:13+00:00,＃デイトラ 実務編 Git・Gulp！チームでコーディングする手法について学習！実務編の名にふさわしい大事な要素が盛り沢山でした！デザイナーさんとの情報共有についても、自習室でFigmaを用いた手法を教えて頂けることに。@ishikawa_s_さん実演を踏まえたわかりやすいレクチャー有難うございました。,10,0,118,81,https://twitter.com/rightlight_web/status/1553409388152442881,10
1553398641410605056,sino55868182,2022-07-30 15:14:31+00:00,記事を投稿しました！ SciPyのMILPは使えるのか？？（SciPy==1.9.0の新機能の検証） [Python] on #Qiita https://t.co/kRDWSVugho,16,5,8,36,https://twitter.com/sino55868182/status/1553398641410605056,21
1553394076824657920,Nao_3ne3,2022-07-30 14:56:23+00:00,今日やったこと&lt;PF実装&gt; 8~15h︎︎︎︎︎︎☑︎ヘッダー作成︎︎︎︎︎︎☑︎トップページ作成Tailwind適用できた😆って思ったのも束の間、変更したあとビルドせずに適用されないなんで？って悩んで無駄な時間を費やした🫠あとgitにも翻弄された⚡仮ページだけどトップページあるとやる気出る😊,14,0,208,175,https://twitter.com/Nao_3ne3/status/1553394076824657920,14
1553378335665049600,momochanjazz,2022-07-30 13:53:50+00:00,#今日の積み上げ🌷︎・Vue2課題14(あとちょっと)・勉強会×2・gitの学習動画を視聴・学会発表の資料作成今日は沢山のエンジニアやデザイナーの方々と話せて楽しかった〜！Vueの課題終わらせてから寝ます😇今は帰宅中……#エンジニアと繋がりたい#javascript #vuejs,17,1,659,547,https://twitter.com/momochanjazz/status/1553378335665049600,18
1553373175249256449,creater_kitsune,2022-07-30 13:33:19+00:00,お疲れ様です！本日も案件対応で積み上げました！使っていなかったGitを使い始めました！なんで今まで使っていなかったのか...💦#今日の積み上げ　✅LP アニメーション提案コーディング 案件対応✅デイトラ  Git、Github復習✅読書 Git入門　#駆け出しエンジニアと繋がりたい #Shopify,11,1,199,158,https://twitter.com/creater_kitsune/status/1553373175249256449,12
1553354564019298305,kemicch,2022-07-30 12:19:22+00:00,day30: 1h30mtotal: 137h50mgit総復習、Linuxコマンド。今日は一日中あちこち移動していて、隙間でなんとか学習してましたが流石に疲れました…今夜はこれからゆっくり休みます。明日で初月終了なので、環境構築までは終わらせて１ヶ月目着地の予定です。,16,0,160,158,https://twitter.com/kemicch/status/1553354564019298305,16
1553306729718263808,2022Fengla,2022-07-30 09:09:18+00:00,"未経験者の戦力化にどの位かかるかって？うーん、HTML/CSS/JSP+Servlet+SQL+gitでチーム開発なら1,000時間欲しいわね🤔Springならもっとかかりそう。でも現実は研修300時間でSES客先常駐にぶっ込まれる例があとを絶たない😱みんな生きてる？#プログラミング初学者 #駆け出しエンジニアと繋がりたい",84,1,92,86,https://twitter.com/2022Fengla/status/1553306729718263808,85
1553302230530265088,_shiooon_01,2022-07-30 08:51:25+00:00,今日はgitエラーマンを倒せました！！HPは。。。1ミリしか残ってません笑😁😝 https://t.co/kbVuzZrYGT,20,3,59,54,https://twitter.com/_shiooon_01/status/1553302230530265088,23
