1564578458742665216,tomohito_study,2022-08-30 11:39:07+00:00,Pythonと仲良くなりたい,10,0,955,1562,https://twitter.com/tomohito_study/status/1564578458742665216,10
1564568614887464961,yoko_materialDX,2022-08-30 11:00:00+00:00,#機械学習 による分子の物性予測のツール。流行りのグラフニューラルネットワークにより分子物性を予測する新しいpythonパッケージMolGraph。従来のパッケージよりTensorFlowやKerasとの互換性を重視し実装の柔軟性が高いとのこと。まずはDeepChem、マニアはMolGraph。https://t.co/8vp28CNcbc,14,2,1543,543,https://twitter.com/yoko_materialDX/status/1564568614887464961,16
1564567966938591232,tantan_python,2022-08-30 10:57:26+00:00,コロ休明けの出勤即残業…wまたツウィートしていきます開業祝いに強敵(とも)より頂きましたBlind Guardianは最強です https://t.co/wfilIWm5gB,14,0,1451,1357,https://twitter.com/tantan_python/status/1564567966938591232,14
1564564310218928128,hachi_python,2022-08-30 10:42:54+00:00,プログラミング初心者のpython稼ぎ方①基礎文法学習&amp;問題演習②課題代行サービスを最低料金で出品して稼ぐことでモチベーション維持③サイト監視ツール作成スキルを勉強④自動化ツール作成サービスを出品⑤②④で稼ぎつつサイト監視ツールを出品#駆け出しエンジニアと繋がりたい,13,0,863,128,https://twitter.com/hachi_python/status/1564564310218928128,13
1564557746368049154,YukiIkeda0810,2022-08-30 10:16:49+00:00,出村先生(@NetDemura)より「ROS2とPythonで作って学ぶAIロボット入門」をご恵贈いただきました。AIロボットについて幅広くまとまっているので、入門にはもってこいの一冊です！しかもなんと、我々が開発したSOBITくんやTeam SOBITSについても紹介していただいてます！#ROS2 #Python #Robotics https://t.co/OYQyIvJOLP,22,6,607,324,https://twitter.com/YukiIkeda0810/status/1564557746368049154,28
1564553522632343555,fish_burozimapy,2022-08-30 10:00:02+00:00,~16日目の学び~flatten()で多次元配列を1次元配列に変換!#100日チャレンジ#Python #駆け出しエンジニアと繋がりたい今日の参考文献↓☟Pythonにおけるflatten()の利用方法を現役エンジニアが解説【初心者向け】 #テックアカデミー @techacademy https://t.co/kgTsVO54uA https://t.co/qS60ZLdg31,12,1,67,63,https://twitter.com/fish_burozimapy/status/1564553522632343555,13
1564553252498448385,rei_01web,2022-08-30 09:58:58+00:00,おすすめのプログラミング言語ってありますか？Pythonはなんか難しそうで食わず嫌い状態なんですけど、、#web制作#駆け出しwebデザイナーと繋がりたい #駆け出しエンジニアと繋がりたい,13,0,63,110,https://twitter.com/rei_01web/status/1564553252498448385,13
1564538545707986944,kira_python,2022-08-30 09:00:31+00:00,じゃんけんアプリつくってみた✌️Pythonだと簡単に作ることができます！数年前まで何もできなかった自分が…#駆け出しエンジニアと繋がりたい#プログラミング https://t.co/9LgPJoPwv7,25,1,746,577,https://twitter.com/kira_python/status/1564538545707986944,26
1564538485469749251,Mizuiro__sakura,2022-08-30 09:00:17+00:00,反応拡散系Gray-Scottモデル(2種類の化学物質が反応しながら拡散していく様子)のシミュレーションのソースコードです。#プログラミング#プログラミング初学者と繋がりたい #駆け出しエンジニアと繋がりたい #python#反応拡散系 https://t.co/EJ3OaKoYQz,20,2,126,161,https://twitter.com/Mizuiro__sakura/status/1564538485469749251,22
1564538415084965891,moguravrjob,2022-08-30 09:00:00+00:00,外資系コンサルPwCでは、PythonコーディングによるDigital Productの開発経験のある技術戦略コンサルタントを募集しています。知財の調査・分析の経験もあると◎。#AR #MR #VR #メタバース #転職 #リモートワーク可https://t.co/wbc9N2QJat,13,5,65,20,https://twitter.com/moguravrjob/status/1564538415084965891,18
1564538387373395969,GIANT_KILLING_0,2022-08-30 08:59:53+00:00,バックエンドで頑張ろうと思ったらJavaScriptは絶対勉強しとかなあかんのか！！#Python#JavaScript#駆け出しエンジニアと繋がりたい#プログラミング初心者と繋がりたい#プログラミング＃エンジニア,51,5,10,13,https://twitter.com/GIANT_KILLING_0/status/1564538387373395969,56
1564538342657921024,Mizuiro__sakura,2022-08-30 08:59:43+00:00,反応拡散系Gray-Scottモデル(2種類の化学物質が反応しながら拡散していく様子)のシミュレーションです。ソースコードは次のスライドを見て下さい。#プログラミング#プログラミング初学者と繋がりたい #駆け出しエンジニアと繋がりたい #python#反応拡散系 https://t.co/gkeGSfIt4J,21,1,126,161,https://twitter.com/Mizuiro__sakura/status/1564538342657921024,22
1564536716891148288,norisukeoptions,2022-08-30 08:53:15+00:00,オプション雑談以前どぶさん@dobumeadに教えてもらったPythonのコードと自分の書籍を掻き集めブラック・ショールズ方程式によるオプション理論価格を原始的にExcelで計算してみました笑ヽ(=´▽`=)ﾉ計算結果もmarket chameleonの結果と微差でしたので合っているはずです笑どぶさんありがとうm(__)m https://t.co/uIAcwxcILD,43,0,1940,1381,https://twitter.com/norisukeoptions/status/1564536716891148288,43
1564530362985762816,TQrs0,2022-08-30 08:28:00+00:00,8月29日学習報告・300記事ノック5本・過去動画 【Programming】Python入門1本やる事を多く抱え過ぎている為、自分ができる範囲に収めるべく別方向の工夫をする日々。優先順位と取捨選択#RareTECH 66日目#駆け出しエンジニアと繋がりたい #希少型エンジニア を目指して#プログラミング勉強中,14,0,31,0,https://twitter.com/TQrs0/status/1564530362985762816,14
1564508518052335616,OctoparseJapan,2022-08-30 07:01:12+00:00,情報収集に時間がかかる？能動的に海外不動産情報を収集頂きたい？今回は、Octoparseを使い、海外不動産データを取得する方法とデータの活用について解説👇👇ぜひご参考ください🙇‍♂️https://t.co/sphvbwGccv #Python#駆け出しエンジニアと繋がりたい#スクレイピング#不動産仲介 #海外不動産 https://t.co/VUryesuyJa,12,0,324,182,https://twitter.com/OctoparseJapan/status/1564508518052335616,12
1564500671722041344,y__hayashi,2022-08-30 06:30:01+00:00,プログラミング初心者、駆け出しエンジニアの手伝いをします https://t.co/ucQNXnxRkk#buildree #php #Laravel #fuelphp #フレームワーク #apache #nginx #エンジニア #python #go #nodejs #プログラミング学習 #プログラミング初心者,15,1,189,70,https://twitter.com/y__hayashi/status/1564500671722041344,16
1564499029345505280,vetlanprogramer,2022-08-30 06:23:30+00:00,Railsエンジニアの年収は安い。３５０万くらいだろう。駆け出しは　東京限定で求人は少ない　Web系くらいしか使っていない。大手の企業はみんなJavaやC#　あとpythonだろう。 38   #駆け出しエンジニアと繋がりたい,23,1,184,0,https://twitter.com/vetlanprogramer/status/1564499029345505280,24
1564497700845809664,haruto_python,2022-08-30 06:18:13+00:00,【初心者でも稼げる】バイナンスIEO参加してみた！（Launchpad）＜2020年8月＞#バイナンス https://t.co/2CkcjiaClh,23,23,333,787,https://twitter.com/haruto_python/status/1564497700845809664,46
1564488965700612102,OS_7910,2022-08-30 05:43:30+00:00,プログラミング仲間が欲しいのでフォローして欲しいです！#プログラミング独学 #プログラミング #プログラミング初心者 #プログラミング勉強中 #flask #Python,31,2,92,59,https://twitter.com/OS_7910/status/1564488965700612102,33
1564488774343864320,ashitsunokara,2022-08-30 05:42:45+00:00,競技プログラミングを始める前に書いたPythonのスクリプトを初めから書き直して高速化をはかってます……。,11,1,411,1471,https://twitter.com/ashitsunokara/status/1564488774343864320,12
1564486838143709184,araratoshi,2022-08-30 05:35:03+00:00,こんにちは🥰#さざんぴあ博多 でトレーニング後、自習スペースで学習中です😊ChromeOS Flexで復活したchromebookに、Pythonの学習環境が整ったので、Pythonも学習しています😊 https://t.co/CNkHiz16su,26,0,197,203,https://twitter.com/araratoshi/status/1564486838143709184,26
1564486387143168002,hachi_python,2022-08-30 05:33:16+00:00,プログラミング勉強の初期はみんな浮気しがちここを浮気せずに一途な人は稼ぐまでの時間も最短一途になることを心掛けよう#駆け出しエンジニアと繋がりたい,26,0,863,128,https://twitter.com/hachi_python/status/1564486387143168002,26
1564485572650930176,y__hayashi,2022-08-30 05:30:01+00:00,Buildree実行後は、すぐに本業に専念できます https://t.co/ucQNXnOUmk#buildree #php #Laravel #fuelphp #フレームワーク #apache #nginx #エンジニア #python #go #nodejs #プログラミング学習 #プログラミング初心者,14,2,189,70,https://twitter.com/y__hayashi/status/1564485572650930176,16
1564484821413310464,1978works,2022-08-30 05:27:02+00:00,ブログを更新しました。PythonでエックスサーバーのMySQLを使おうとしてエラー続出もMySQL ConnectorからPyMySQLに替えると解決https://t.co/1Hx7b6Gx3O#ブログ #ブログ更新 #wordpress #プログラミング #Python #プログラミング勉強中 #プログラミング初学者,10,2,35,0,https://twitter.com/1978works/status/1564484821413310464,12
1564479619021312000,buriburixburi,2022-08-30 05:06:22+00:00,ProgateでPython勉強してたらレッスン２途中で有料会員登録を求められた…ちょうど1か月くらい時間に余裕があるから有料でもいいかなーと思うんだけど、それとも作りたい目標物に焦点当てて本&amp;ネットで独学すべきかどっちがいいだろうか。。#Python #Progate #プログラミング初心者と繋がりたい,17,1,24,54,https://twitter.com/buriburixburi/status/1564479619021312000,18
1564575241346895872,ikuji_system,2022-08-30 11:26:20+00:00,なんかすごいシステム進化してる！アミュレット一覧でステータス見れたり、まとめてレベル上げできたり。エンジニア様、運営様ありがとうございます！！あとは、自分の日別獲得deapcheckが、スカラーさんみたいにわかるようになって欲しい。届けこの想い！！#jobtribes#ときどき記録忘れます,31,1,985,163,https://twitter.com/ikuji_system/status/1564575241346895872,32
1564572768196501504,Hide_sgs,2022-08-30 11:16:30+00:00,うわぁ、と言う感想しか出てこない。結局規約に書いていれば守ってもらえるか、最悪法的手段で賠償取れる企業を相手にしてきたエンジニアが、無自覚の悪意も含む大量の個人を相手にすることになる点を想定してなかったサービスだったか。でもこれ解決すんの難しすぎるぞ絶対。 https://t.co/OFyHBwKMBa,15,4,741,550,https://twitter.com/Hide_sgs/status/1564572768196501504,19
1564566186846588929,npx_999,2022-08-30 10:50:21+00:00,えろかわエンジニアいないん？#駆け出しエンジニアと繋がりたい #中出しエンジニアでもいい,12,0,18,12,https://twitter.com/npx_999/status/1564566186846588929,12
1564562620807774208,aumy_f,2022-08-30 10:36:11+00:00,「法律の専門家はそんなズバッと真理を言ってくれるようなもんではない」という意見を頂戴した。しょせん僕も法律をろくに知らないITエンジニアです！,13,1,446,359,https://twitter.com/aumy_f/status/1564562620807774208,14
1564561746261553152,m__parts,2022-08-30 10:32:43+00:00,皆さんこんばんは‼先程、美容機器メーカーさんが飛び込みで来られました。ネジを外して欲しいと言う事で、丁度展示デモ機のネジザウルスでスパッと解決🤩🤩🤩ご購入も頂きました😄👌でも何でこんなに曲がっているのか…一家に1本ネジザウルス🤩#エンジニア#ネジザウルス https://t.co/mcye6NTECM,31,0,437,423,https://twitter.com/m__parts/status/1564561746261553152,31
1564560600339886080,n0mimono,2022-08-30 10:28:09+00:00,ミラティブではエンジニアを大募集中です！・iOS／Android／Unity・フロントエンド／バックエンド・インフラ／ストリーミング・エンジニアリングマネージャー／わかりあいテックhttps://t.co/3MdoZa4iCs,17,9,1540,899,https://twitter.com/n0mimono/status/1564560600339886080,26
1564560504529776640,t_o_fu,2022-08-30 10:27:47+00:00,リオジョン、陰の気強いジョンだけどエンジニアと並ぶと突然ウェイの気出てくるのウケてしまった　なんか懐かしい並びだったな東山さんとりおさん,13,0,915,306,https://twitter.com/t_o_fu/status/1564560504529776640,13
1564559977540616193,yoh27_,2022-08-30 10:25:41+00:00,「wp」ってなんの略です？これがホワイトペーパーに見えたのであれば、マーケター。WordPressに見えたのであれば、エンジニア。みんなはどう？,10,0,1321,271,https://twitter.com/yoh27_/status/1564559977540616193,10
1564559832962985986,tamaco08,2022-08-30 10:25:06+00:00,8/30ソワレ🇻🇳東山エンジニア〜💕補助席サイド、運良く見やすい♬前回S席後方でセンターが丁度前の人の頭で見えなかったから今日は良き良き。充希キム、歌のど迫力凄い。西川トゥイも迫力増してません？#ミス・サイゴン https://t.co/gPjlTVM52s,22,0,107,357,https://twitter.com/tamaco08/status/1564559832962985986,22
1564555774420217856,mren_0614,2022-08-30 10:08:59+00:00,エンジニアの皆さんへ僕はコードの処理の流れとかが頭の中でこんがらがったとき、ノートに手書きで整理してるんですけど。。エンジニアの皆さんはどうしてますか？？(もはやこんがらがることすらないとか。。？😱)#駆け出しエンジニアと繋がりたい ＃Webエンジニア,15,0,136,144,https://twitter.com/mren_0614/status/1564555774420217856,15
1564553522632343555,fish_burozimapy,2022-08-30 10:00:02+00:00,~16日目の学び~flatten()で多次元配列を1次元配列に変換!#100日チャレンジ#Python #駆け出しエンジニアと繋がりたい今日の参考文献↓☟Pythonにおけるflatten()の利用方法を現役エンジニアが解説【初心者向け】 #テックアカデミー @techacademy https://t.co/kgTsVO54uA https://t.co/qS60ZLdg31,12,1,67,63,https://twitter.com/fish_burozimapy/status/1564553522632343555,13
1564550857487618048,MakotoDirector,2022-08-30 09:49:27+00:00,営業、デザイナー、エンジニア。やることも視点も違うので、険悪になることもある。険悪にならず、それぞれ良い関係で仕事ができるかどうかはディレクターの腕にかかってる。ディレクターって「会社とお客様の仲」そして「チームメンバーの仲」を繋げる、愛のキューピッドだった😇,20,0,225,1,https://twitter.com/MakotoDirector/status/1564550857487618048,20
1564550253344587777,kota_0991,2022-08-30 09:47:02+00:00,お疲れ様です！今日は久しぶりに早上がりできました😊どこか美味しいラーメンでも食べて帰ろうかな！帰宅後はゆっくりjQueryの勉強をしよう💪#エンジニア#駆け出しエンジニアと繋がりたい #ITエンジニア,11,0,209,203,https://twitter.com/kota_0991/status/1564550253344587777,11
1564548157127757824,i_like_ruby,2022-08-30 09:38:43+00:00,格安で #プログラミング学習 のメンターしています。無料相談実施中です！#プログラミング#エンジニア#プログラミング初心者#プログラミング初学者#駆け出しエンジニアと繋がりたい#駆け出しエンジニアとつながりたい#プログラミング初心者と繋がりたいhttps://t.co/Q5Q1SOnaFX,10,1,460,110,https://twitter.com/i_like_ruby/status/1564548157127757824,11
1564546329375698944,_yy616,2022-08-30 09:31:27+00:00,久しぶりの投稿です。新卒エンジニア就職について書きました。#駆け出しエンジニアと繋がりたい #エンジニア転職 #エンジニア就活 #駆け出しエンジニア #新卒https://t.co/Ep7PvgOdof,11,3,398,146,https://twitter.com/_yy616/status/1564546329375698944,14
1564546238023798784,pr_fed,2022-08-30 09:31:05+00:00,今日も1日お疲れ様でしたദ്ദി^._.^)新宿区は現在土砂降りです☔️みなさん帰宅の際は足元お気を付けてください！#エンジニア #企業公式がお疲れさまを言い合う #現在の天気#企業公式中の人 #企業公式相互フォロー #株式会社ダイブ #fed,11,0,681,657,https://twitter.com/pr_fed/status/1564546238023798784,11
1564543847857680384,u5musicxit,2022-08-30 09:21:35+00:00,フリーランスになって3ヶ月ぐらいが経つんだけど再来月からの給料がエグすぎてパニクってるわけわからんはエンジニアたかが3年でわけわからん#駆け出しエンジニアと繋がりたい,12,0,119,76,https://twitter.com/u5musicxit/status/1564543847857680384,12
1564542792168525825,punk_punx,2022-08-30 09:17:24+00:00,久々にnote書きました。Verticav SaaSの開発はほんとうにエンジニアにとって面白いので、ぜひ読んでみてください！https://t.co/dXqcHo6lqE,14,6,1146,1117,https://twitter.com/punk_punx/status/1564542792168525825,20
1564540577600774144,ton09876286,2022-08-30 09:08:36+00:00,IT WEB エンジニア向け人気転職サイト「2022最新　3選」おすすめhttps://t.co/s8lNFovOq6#プログラミング初心者 #エンジニア転職 #駆け出しエンジニアと繋がりたい https://t.co/9T5RtgjZqx,10,0,1519,4939,https://twitter.com/ton09876286/status/1564540577600774144,10
1564540421480452096,ton09876286,2022-08-30 09:07:58+00:00,時流はエンジニアです比較した転職サイトで収入アップおすすめhttps://t.co/2pcJYgYJ2V#プログラミング初心者 #エンジニア転職 #駆け出しエンジニアと繋がりたい https://t.co/E5DLFtszbs,12,0,1519,4939,https://twitter.com/ton09876286/status/1564540421480452096,12
1564538959430324224,PJ_TC_dejica,2022-08-30 09:02:10+00:00,弊社の『Stand with Ukraine』キャンペーンにご賛同いただいた、株式会社ONE STORY AWARD様のウェブサイトです。このサイトの制作費の一部はウクライナのITエンジニアに支払われ、更にウクライナの子どもたちのために寄付されます。#企業公式がお疲れ様を言い合う https://t.co/DOmmxvvkGI,11,1,113,14,https://twitter.com/PJ_TC_dejica/status/1564538959430324224,12
1564568614887464961,yoko_materialDX,2022-08-30 11:00:00+00:00,#機械学習 による分子の物性予測のツール。流行りのグラフニューラルネットワークにより分子物性を予測する新しいpythonパッケージMolGraph。従来のパッケージよりTensorFlowやKerasとの互換性を重視し実装の柔軟性が高いとのこと。まずはDeepChem、マニアはMolGraph。https://t.co/8vp28CNcbc,14,2,1543,543,https://twitter.com/yoko_materialDX/status/1564568614887464961,16
1564447825772961792,AxrossRecipe_SB,2022-08-30 03:00:02+00:00,ELECTRAという言語モデルを使用してユーザからの質問に応答するプログラム動かしながら学ぶことができます。チャットボットや音声アシスタントに活用することができます。https://t.co/DcTGu9Zu8S#AxrossRecipe#機械学習#自然言語処理 #プログラミング学習#駆け出しエンジニアと繋がりたい,15,0,1067,83,https://twitter.com/AxrossRecipe_SB/status/1564447825772961792,15
1564447794605490176,meitec_group,2022-08-30 02:59:54+00:00,米ミネソタ大学の研究チームが、脳信号を使用してロボットアームを動かすことを可能にする、正確で侵襲性の低い技術を開発し、思考だけで義手を操作することに成功。AIや機械学習の最新研究成果をぜひご覧ください。https://t.co/rxUCD3JQ41#fabcross #AI #機械学習 #メイテック https://t.co/dbrPILvBVI,28,2,1759,0,https://twitter.com/meitec_group/status/1564447794605490176,30
1564405304405925888,QrAaSbHbEiRt,2022-08-30 00:11:04+00:00,Udemyセール中という事を知り、初めて動画を購入してみました♡本の学習だけではダメだと思いまして復習に1つ今勉強してる機械学習関連を4つ買いました！見るの楽しみです(*^^*)#python#機械学習#プログラミング初心者と繋がりたい#駆け出しエンジニアと繋がりたい,32,0,1675,640,https://twitter.com/QrAaSbHbEiRt/status/1564405304405925888,32
1564372323515437056,nekoallllergy,2022-08-29 22:00:01+00:00,#DeepLearning フレームワークの #Keras に同梱されているサンプルのデータセットは7つです。#機械学習 #Python #プログラミング初心者 #プログラミング初心者と繋がりたい  詳しくはこちらから↓https://t.co/3L461kmy1k https://t.co/Wi7clLfqH1,12,0,172,102,https://twitter.com/nekoallllergy/status/1564372323515437056,12
1564176035549433856,suzuki_py,2022-08-29 09:00:02+00:00,Qiitaで #機械学習 に関する投稿を定期的に漁ってます！#プログラミング#プログラミング初心者#駆け出しエンジニアと繋がりたい【強化学習】MuZeroを解説・実装https://t.co/lEa8JTiZF4,26,1,495,307,https://twitter.com/suzuki_py/status/1564176035549433856,27
1564069078217547776,tenshokustories,2022-08-29 01:55:01+00:00,#プログラミングスクール を解説🙆‍♂️スタートラボの評判・口コミは？Pythonを低価格で学習できる【未経験向け】スクール！https://t.co/RH9aIVUUpj#スタートラボ#StartLab　#python #機械学習#新人エンジニア#プログラミング初心者#プログラミング未経験#駆け出しエンジニアと繋がりたい,10,1,1091,2781,https://twitter.com/tenshokustories/status/1564069078217547776,11
1564038887831666688,tenshokusitai7,2022-08-28 23:55:03+00:00,"7月の副業代8,000円8月の副業代20,000円だいぶ伸びてきたなぁ…😊✨#Python#機械学習#副業#Lansers",16,1,623,592,https://twitter.com/tenshokusitai7/status/1564038887831666688,17
1563869633370722304,kabujijiji,2022-08-28 12:42:30+00:00,今週の株価予測👨‍💻S&amp;P500は、週足で陽線になると予測します(確率64％)月曜の始値＜金曜の終値、ってことですね。ただ…非常に難しい😅予測モデルを2個使っていますが、それぞれ結果が異なっており、AIも迷っている😇月曜からの相場が楽しみですね✨#機械学習 #株価予測#投資家さんと繋がりたい,34,0,1614,949,https://twitter.com/kabujijiji/status/1563869633370722304,34
1563852103826624518,orange_horse_39,2022-08-28 11:32:51+00:00,#キーランドC #Python#機械学習結局騎手が上手かったよな～👍️皐月賞のゴールドシップみたいだった🎵騎手の勝率しかデータ使ってなかったけど、次から連対率と複勝率も使って学習させるか😏新潟記念頑張りましょー,12,0,885,900,https://twitter.com/orange_horse_39/status/1563852103826624518,12
1563813646282547200,suzuki_py,2022-08-28 09:00:02+00:00,Qiitaで #機械学習 に関する投稿を定期的に漁ってます！#プログラミング#プログラミング初心者#駆け出しエンジニアと繋がりたい今さら聞けない機械学習https://t.co/k5SN8OJt8F,30,2,495,307,https://twitter.com/suzuki_py/status/1563813646282547200,32
1563750259074875392,QrAaSbHbEiRt,2022-08-28 04:48:09+00:00,何度も確認して本の通りに入力したのにエラーが出てる…エラーの意味も調べたわからないからまた最初からやり直そう！今日はもう勉強時間過ぎたのでまた明日に持ち越しですw#python#機械学習#プログラミング初心者と繋がりたい#駆け出しエンジニアと繋がりたい,64,3,1675,640,https://twitter.com/QrAaSbHbEiRt/status/1563750259074875392,67
1563338563659640834,kabujijiji,2022-08-27 01:32:13+00:00,今週の株価予測の答え合わせ👨‍💻S&amp;P500(週足・8/22~8/26)AI予測:陽線結果:陰線昨晩のパウちゃんスピーチまでは順調で、これはいける！と思ったけど最後にやられた🥲ま、そんな簡単に当たったら苦労せんよな🙄滅気ずにプログラム改良しながら続けていきます！トータル戦績:０勝１敗☔#機械学習,32,0,1614,949,https://twitter.com/kabujijiji/status/1563338563659640834,32
1563266671963688960,choappceo,2022-08-26 20:46:33+00:00,やっほー！未来の会社チョウアップです！https://t.co/LgOyljcXnf#先端技術研究開発 #創業準備中 #AI #機械学習 #データサイエンス #メタバース #プログラミング #アプリ開発 #Python #Scratch  #ハッキング #子供の頃からプログラマー #プログラマー #起業家 #CEO https://t.co/4LV3Ze2mbG https://t.co/qtpJ8PawbV,9,2,231,61,https://twitter.com/choappceo/status/1563266671963688960,11
1563134310823395329,QrAaSbHbEiRt,2022-08-26 12:00:35+00:00,ううぅぅぅ……覚えられない……何度も何度も手を動かさねば#python#機械学習#プログラミング#プログラミング初心者と繋がりたい#駆け出しエンジニアと繋がりたい,23,1,1675,640,https://twitter.com/QrAaSbHbEiRt/status/1563134310823395329,24
1562847469096304647,riko_o_____,2022-08-25 17:00:47+00:00,自己紹介・理系大学生(情報系)・投資初心者・アルゴトレードにも多少興味あり・機械学習仮想通貨に興味あります...！😣よろしくお願いします！#仮想通貨#投資#投資家さんと繋がりたい #投資初心者さんと繋がりたい#機械学習,37,0,18,53,https://twitter.com/riko_o_____/status/1562847469096304647,37
1562799285284270080,haposaisai,2022-08-25 13:49:19+00:00,AIで画像生成する #stablediffusion を試しに使って、指定した画像(右)から新しい画像(左)を生成しました♬プロンプトの書き方がよくわからなかったので「ハムスター」とだけ入力したら、マイクからハムスターみたいなものが飛び出す怪しい画像ができましたw #Img2Img #AI #機械学習 #人工知能 #写真 https://t.co/gQu3V23ThM,41,4,1459,1391,https://twitter.com/haposaisai/status/1562799285284270080,45
1562726484791349253,aoi_studyai,2022-08-25 09:00:02+00:00,👇今日の気になるAIニュース「人気プログラミング言語2022」が発表されるhttps://t.co/0VXuTGRkYpSpectrum / Jobs / Trending、3パターンでの集計結果を確認できます。Pythonはどの集計でもTOP3入りしています🎉✨#AI #人工知能 #機械学習 #python #駆け出しエンジニアと繋がりたい,13,0,1906,1426,https://twitter.com/aoi_studyai/status/1562726484791349253,13
1562681211792723969,tenshokustories,2022-08-25 06:00:08+00:00,#プログラミングスクール を解説🙆‍♂️スタートラボの評判・口コミは？Pythonを低価格で学習できる【未経験向け】スクール！https://t.co/RH9aIVUUpj#スタートラボ#StartLab　#python #機械学習#新人エンジニア#プログラミング初心者#プログラミング未経験#駆け出しエンジニアと繋がりたい,15,5,1091,2781,https://twitter.com/tenshokustories/status/1562681211792723969,20
1562623153670479879,Ryosuke08281,2022-08-25 02:09:26+00:00,python勉強して3ヶ月。まだ何か形として結果には残せて無いけど挫折せずにがんばれそう。#プログラミング初心者と繋がりたい #python#機械学習#AI,13,1,27,39,https://twitter.com/Ryosuke08281/status/1562623153670479879,14
1562590579665653760,griddb_jp,2022-08-25 00:00:00+00:00,"#Java と #GridDB を使用した #アンサンブル学習 方法(#AdaBoost,#Bagging,#Stacking  と #Voting) の実装： https://t.co/7ipNlqIe4k #Qiita #opensource #oss #machinelearning #ml#オープンソース #機械学習 #駆け出しエンジニアとつながりたい  #駆け出しエンジニアと繋がりたい",12,3,1964,1629,https://twitter.com/griddb_jp/status/1562590579665653760,15
1562441206990516224,kurodotty,2022-08-24 14:06:27+00:00,経済学からデータサイエンスへの接続に役立った知識・必要になった知識をまとめてみた | ダイナミックプラス株式会社's post by @kotaro3taro #分析 #機械学習 #データ分析 https://t.co/aufyqkjP8W,69,9,1982,987,https://twitter.com/kurodotty/status/1562441206990516224,78
1562424492378447872,aoi_studyai,2022-08-24 13:00:02+00:00,👇今日の気になるAIニュース【Python】seabornで綺麗なグラフ作成を！たった1行で書けますhttps://t.co/96H5GcWq00Pythonでのグラフの書き方について、初心者🔰向けに分かりやすくまとめられています📚✨#AI #人工知能 #機械学習 #python #駆け出しエンジニアと繋がりたい,13,1,1906,1426,https://twitter.com/aoi_studyai/status/1562424492378447872,14
1562364089476583424,griddb_jp,2022-08-24 09:00:00+00:00,TensorFlow.jsを使用して赤ワインの品質を予測しよう：https://t.co/vGzB4OZ38q#OpenSource #OSS #TensorFlow #MachineLearning #ML #AI #nodejs #JavaScript #DataScience  #オープンソース #機械学習 #データサイエンス #駆け出しエンジニアとつながりたい #駆け出しエンジニアと繋がりたい,13,6,1964,1629,https://twitter.com/griddb_jp/status/1562364089476583424,19
1562318627940212737,KMoco0109,2022-08-24 05:59:22+00:00,レッツ！“Ensemble!”#駆け出しエンジニアと繋がりたい#機械学習 #Ensemble https://t.co/Pw4cWJlY5z,14,1,94,62,https://twitter.com/KMoco0109/status/1562318627940212737,15
1562316971617796096,selfdevelop2019,2022-08-24 05:52:47+00:00,ブログ連続更新866日#ブログ #プログラミング勉強中  #プログラマー #機械学習 #スクレイピング #Python #プログラミング #PHP #Ubuntu #仮想通貨 #メタバース #プログラミング独学 https://t.co/MOueu6dzwk,9,1,140,0,https://twitter.com/selfdevelop2019/status/1562316971617796096,10
1562075954888921088,tenshokustories,2022-08-23 13:55:04+00:00,#プログラミングスクール を解説🙆‍♂️スタートラボの評判・口コミは？Pythonを低価格で学習できる【未経験向け】スクール！https://t.co/RH9aIVUUpj#スタートラボ#StartLab　#python #機械学習#新人エンジニア#プログラミング初心者#プログラミング未経験#駆け出しエンジニアと繋がりたい,13,0,1091,2781,https://twitter.com/tenshokustories/status/1562075954888921088,13
1562001703271952388,AxrossRecipe_SB,2022-08-23 09:00:01+00:00,PyTorch機能のtorchaudioを利用してデータを読み込み、より簡単に機械学習のデータ前処理の準備を行う手法を解説したレシピです。https://t.co/F6dLBf54m5#AxrossRecipe #機械学習#音声認識#プログラミング学習#駆け出しエンジニアと繋がりたい,17,1,1067,83,https://twitter.com/AxrossRecipe_SB/status/1562001703271952388,18
1561887019344986113,acroquest,2022-08-23 01:24:18+00:00,【『第11回 全日本コンピュータビジョン勉強会』に当社Kaggle Grandmasterが登壇しました】8/21に開催されたオンラインイベント『 #CVPR 2022論文読み会』に当社の #機械学習 エンジニア・山本が登壇しました。https://t.co/2Fz5wUJZHX,11,9,967,1422,https://twitter.com/acroquest/status/1561887019344986113,20
1561748812775198721,chantatsu_blog,2022-08-22 16:15:07+00:00,Pythonを用いた機械学習の基礎を紹介しています！初心者の方で基礎を抑えて進めたい方必見です！#ブログ #Python #Python初心者#プログラミング初心者と繋がりたいhttps://t.co/GU3ZQkNuAL,14,1,141,187,https://twitter.com/chantatsu_blog/status/1561748812775198721,15
1561728029201559552,mofu_usam,2022-08-22 14:52:32+00:00,115投稿目Flaskで画像投稿機能を作りましたcssフレームワークのpureを使ってますサンプルコードはタイプミスで気が付かないことが多いので辛い　特に動いちゃったとき#機械学習#100日間pythonを勉強してみる#Python #プログラミング初心者#プログラミング独学 #駆け出しエンジニアと繋がりたい,21,0,689,419,https://twitter.com/mofu_usam/status/1561728029201559552,21
1561690799569440774,kabujijiji,2022-08-22 12:24:36+00:00,早速今週の予測👨‍💻今週のS&amp;P500は、週足で陽線になると予測します(確率72％)今晩の始値＜金曜の終値、ってことですね。…でも、今週はたくさん景気指数の発表あるし、ジャクソンホール会議もあるしな〜外すかもな〜🙄🙄外したら笑ってください🤣🤣🤣笑#機械学習 #株価予測#投資 https://t.co/EfnHE5icSH,22,0,1614,949,https://twitter.com/kabujijiji/status/1561690799569440774,22
1561683836613799936,kabujijiji,2022-08-22 11:56:55+00:00,僕は趣味でプログラミングをやっていますが、始めた当初から明確な目標を持っています。それは「株価予測ＡＩ」を自分の手で作ること！3年程かかりましたが、ようやく形になってきました☺️まだまだ精度は低いですが、自作ＡＩの予測結果をちょっとずつ発信していきたいと思います✨#機械学習#投資,99,0,1614,949,https://twitter.com/kabujijiji/status/1561683836613799936,99
1561669522305691648,yoko_materialDX,2022-08-22 11:00:03+00:00,#機械学習 により構造を判定する論文。実験的に結晶構造を決めるのは大変で材料探索の律速の一つです。深層学習によりX線回折パターンからペロブスカイト型構造か否かを学習し、高速かつ90%の精度で予測できたとのこと。YesかNoの二択問題にしたのがポイントですね。https://t.co/fAuQ5bSZlA,15,2,1543,543,https://twitter.com/yoko_materialDX/status/1561669522305691648,17
1561588562898071552,00infinity_gate,2022-08-22 05:38:20+00:00,明らかに正規分布じゃないのに、正規分布って言ってるKS検定(コルモゴロフ·スミルノフ検定)もSW検定(シャピロ·ウィルク検定)も全然使いものにならないのでは？#Python#プログラミング初心者#機械学習 #統計学 https://t.co/fPmarfQW93,12,2,692,916,https://twitter.com/00infinity_gate/status/1561588562898071552,14
1561337329310130178,aoi_studyai,2022-08-21 13:00:02+00:00,👇今日の気になるAIニュース[MangaRestoration] 漫画のスクリーントーン特化型超解像AIを動かすhttps://t.co/w1vRHS1p8m画質の悪い漫画を復元する方法について、ソースコード＆実装方法が分かりやすく記載されています📚✨#AI #人工知能 #機械学習 #Python #駆け出しエンジニアと繋がりたい,19,0,1906,1426,https://twitter.com/aoi_studyai/status/1561337329310130178,19
1561254370091880448,00infinity_gate,2022-08-21 07:30:23+00:00,外れ値検出として、教師なし学習のLocal Outlier Factor使ってるんだけど、それで検出された外れ値排除してもう一度かけると、また外れ値が検出される。どなたか、事前学習なしで外れ値排除するいい方法知らないですか？#Python #プログラミング初心者 #機械学習,14,3,692,916,https://twitter.com/00infinity_gate/status/1561254370091880448,17
1564505073807663104,momoncheru,2022-08-30 06:47:31+00:00,皆さんの初出勤応援のおかげでようやく新しい仕事にも慣れてきました。保育園のお迎えまで、【探偵AIのリアル·ディープラーニング】早坂 吝(やぶさか)さんを読みます。 https://t.co/FKSnTQB51y,24,0,800,420,https://twitter.com/momoncheru/status/1564505073807663104,24
1564492024686182400,happylab,2022-08-30 05:55:40+00:00,AIのディープラーニングで一般的に人が認知し得る創造物が生まれてくるのを見ていると、人の想像力や記憶が共有世界に存在し、人はそれを各能力においてアクセスしているだけというSF的宗教的設定に思いをはせずにはいられないのにゃ…,10,4,1293,4838,https://twitter.com/happylab/status/1564492024686182400,14
1564455370755801088,chiakikikou,2022-08-30 03:30:01+00:00,今日はオンライントレーニング。ディープラーニングについてです。#チアキ機工⠀#静岡県 #富士市⠀#協働ロボット #協業ロボット #DOBOT⠀#メックマインド #MechMind https://t.co/cpU8rBiKCB,19,1,499,521,https://twitter.com/chiakikikou/status/1564455370755801088,20
1564419261430661120,ShoCoh,2022-08-30 01:06:32+00:00,これ、現代のAIと呼ばれるものの実態はだいたい機械学習がディープラーニングだから、みんな喜んで使ってたmidjourney等も同様に既存のイラストを許可なんて取らずに学習データに利用してるんで・・・みたいな話になってるくるよねそりゃ,25,28,380,3678,https://twitter.com/ShoCoh/status/1564419261430661120,53
1564257062502416385,runi_researcher,2022-08-29 14:22:00+00:00,本が好き♡なタイプのためか、動画を集中して見れる時間が20分程度💦子どもかわたし！いやいや、ここは理解を深めるためにやはり動画で、と志は高いのに。オンライン授業に向いてないタイプかもしれない・・と思いながら、ディープラーニングの分野を進めております。道のりは長い,16,0,158,162,https://twitter.com/runi_researcher/status/1564257062502416385,16
1564210215787978752,fnocef,2022-08-29 11:15:51+00:00,お仕事でAIもやってる技術者視点だと、今のディープラーニング方式では人間のイラストレーターを駆逐するのは無理だと思うよ,17,0,946,737,https://twitter.com/fnocef/status/1564210215787978752,17
1564201147451461632,towel_funnel,2022-08-29 10:39:49+00:00,ディープラーニングって言ってたのにAIに変わっちゃったよね,12,5,1844,942,https://twitter.com/towel_funnel/status/1564201147451461632,17
1564082392935333888,chiakikikou,2022-08-29 02:47:56+00:00,次はディープラーニング。形状不安定のお菓子袋のピックアップチャレンジです。仮のハンドを作ります。#チアキ機工⠀#静岡県 #富士市⠀#協働ロボット #協業ロボット #DOBOT⠀#メックマインド #MechMind https://t.co/IYCYpbH7XJ,19,0,499,521,https://twitter.com/chiakikikou/status/1564082392935333888,19
1563762429871661056,orfevere23,2022-08-28 05:36:31+00:00,#統計学が最強の学問である 数学編かなり時間かかっちゃいましたが、今回は一通り読み終えました。思っていた以上に数学、数学していて、後半からのベクトル、行列、微積分、ディープラーニングは読み応えあり溶けました🫠理解度8割くらいなので、また忘れた頃に再読したいと思います。 https://t.co/aRujs2ua0H,24,0,250,112,https://twitter.com/orfevere23/status/1563762429871661056,24
1563721071110782976,yuh_pen,2022-08-28 02:52:10+00:00,めちゃめちゃ良いAWS教材🧡クラウドとはから始まり、ディープラーニングやサーバーレスアーキテクチャまでハンズオン形式で触れられる🥺 https://t.co/Xb9FadCXc2,18,0,211,722,https://twitter.com/yuh_pen/status/1563721071110782976,18
1563525105044451329,akiyory,2022-08-27 13:53:28+00:00,今回のゼロから作るLightGBMを踏まえて感じた事なんだけど、この機械学習アルゴリズムをゼロから実装する行為って、プログラミング力と理論(アルゴリズム)理解を同時にトレーニングできるめっちゃ良い教材だね。本家のゼロ作ディープラーニングは、めちゃくちゃ良いコンテ(1/n),32,1,475,295,https://twitter.com/akiyory/status/1563525105044451329,33
1563521997715697667,PythonDarth,2022-08-27 13:41:07+00:00,#本日までの積み上げ✅ゼロから作るディープラーニング➡️～6.2.1 重みの初期値を0にする？✅ランニング：6.0㎞ゼロつくが、特にコード面でいよいよ複雑に💦しかし、しょこさん @anemptyarchive が作成されたノートのおかげで、何とか食らいついております😤https://t.co/MNaFiYk2Fl,40,2,1234,1301,https://twitter.com/PythonDarth/status/1563521997715697667,42
1563172467727773698,Guren_gregre77,2022-08-26 14:32:13+00:00,キターーー！！！WL選抜に当選しました！！AI活用実験企画　dNounsNFT✨楽しみたいと思います！実は日本ディープラーニング検定のG検保有者です🤣仕事で使って無くあくまでも知識欲で受けたものですが、AIとブロックチェーンは今後の世界で必須な分野だと思っております。 https://t.co/87laiw2hos,14,2,1430,1424,https://twitter.com/Guren_gregre77/status/1563172467727773698,16
1562705060051558403,Paleatus2,2022-08-25 07:34:54+00:00,ディープラーニングを使い魚の写真から97.9％の精度で属まで同定出来るAIが出来たみたいです。現在はコリドラスやテトラ、プレコ等を含むアマゾンの33属が対象で、約600回のテストで誤同定は12回だそうです。まだ実用性は高く無さそうですが進歩としては大きな初歩では無いでしょうか。 https://t.co/DRaBdQPQfC,13,0,250,222,https://twitter.com/Paleatus2/status/1562705060051558403,13
1562605875143274496,jgsdf_tercom,2022-08-25 01:00:47+00:00,#陸上自衛隊 #開発実験団 は、#AI 研究のための能力向上の一環として、「ディープラーニング検定（#G検定）」及び「データサイエンティスト検定リテラシーレベル（#DS検定）」といったAI研究に関連する #資格取得 を推奨しており、この度、G検定に５名、DS検定に２名が合格しました。#TERCOM https://t.co/UDCk9Crgdp,41,18,1014,56,https://twitter.com/jgsdf_tercom/status/1562605875143274496,59
1562592185132134401,GoToriyama,2022-08-25 00:06:23+00:00,今週末２８日に開催です！ドラえもんを本気で作ろうとしている大澤正彦先生をゲストにお招きして人工知能・AIの最先端の研究のお話やディープラーニングのお話等盛り沢山です。ドラえもんが引き出しから現れる未来はそう遠くないかも知れません。是非ご来場ください！#恵比寿でビズる https://t.co/1R8pmM5Qx5,13,3,955,764,https://twitter.com/GoToriyama/status/1562592185132134401,16
1562417237126180865,PythonDarth,2022-08-24 12:31:12+00:00,#本日の積み上げ✅ゼロから作るディープラーニング➡️〜5章 誤差逆伝播法第5章ニューラルネットワークの実装以降で、長らくエラーで足踏みしておりましたが、漸く解決😅要は、スクラッチした各クラスなどをそのまま使うのではなく、公式配布の方を呼び出し、置き換えていけば通るようです😋,33,0,1234,1301,https://twitter.com/PythonDarth/status/1562417237126180865,33
1564569129943801857,pypy1225,2022-08-30 11:02:03+00:00,データサイエンティストを選んだ理由。変化が激しくても生き残れる人材になりたかったから。「プログラミング×数学×ビジネス ⇒ 高需要」未来がどうなるかは分かりませんが、現時点ではこうかなと。#駆け出しエンジニアと繋がりたい,16,0,728,608,https://twitter.com/pypy1225/status/1564569129943801857,16
1564492201962668033,urora_blue,2022-08-30 05:56:22+00:00,データサイエンティストこそ、まずは現場を見たり現場の人のヒアリングをしたりすべきだなと思った。,20,1,99,248,https://twitter.com/urora_blue/status/1564492201962668033,21
1564487890977312768,technoprodesign,2022-08-30 05:39:14+00:00,データサイエンティストの動画撮影のため、午後から東京の本社に。ここに来たらマックⓂ️🍔🍟です🤤 https://t.co/it0W39HlE8,40,0,1737,1745,https://twitter.com/technoprodesign/status/1564487890977312768,40
1564465483176259586,rike_data_sci,2022-08-30 04:10:12+00:00,今日は統計検定二級の受験日！正直、勉強が足りてる気がしませんが、全力を尽くします💪統計検定が取れたら、ようやくデータサイエンティストのスタートラインに立てたかな😅#24卒 #23卒と繋がりたい #データサイエンス #駆け出しエンジニアと繋がりたい #就活 #転職 #統計,15,0,128,26,https://twitter.com/rike_data_sci/status/1564465483176259586,15
1564448513496600576,At175G5,2022-08-30 03:02:46+00:00,未経験からデータサイエンティストへの転職は出来ます。その代わり…が多いだけ・年収の大幅減・ベンチャー（実態は中小）・能力、スキルが求められる・ドメイン知識がある・学歴見られる・などって考えれば、本当にデータサイエンティストにこだわってるのかが見えてると思うんですよね～～,22,1,351,512,https://twitter.com/At175G5/status/1564448513496600576,23
1564397904692776960,PythonStartLab0,2022-08-29 23:41:40+00:00,おはようございます🙆‍♀️本日は雨🌧️暑さも少し落ち着き心地よい季節になりましたね✨先日お知らせしたデータサイエンティスト入門コース、たくさんの方が登録してくださいました！是非この機会に登録してみてくださいね！今日も1日頑張りましょう⭐️#企業公式が毎朝地元の天気を言い合う https://t.co/y1RQWxp6Gr,17,0,537,639,https://twitter.com/PythonStartLab0/status/1564397904692776960,17
1564327868120739840,kodenkoden,2022-08-29 19:03:22+00:00,転職の面接受けてるとプロフに書いてあるキャリアを見た面接官から「よくデータサイエンティストの部署へ異動できたね」と驚かれる。結果に結びつけて資格と希望をアピールして後は運。仕事で学んだことツィートしていきます。#仕事 #転職 #駆け出しエンジニアと繋がりたい #社会人,15,0,511,216,https://twitter.com/kodenkoden/status/1564327868120739840,15
1564282773216436225,dst_cogit_y2,2022-08-29 16:04:10+00:00,高卒未経験三十代後半でデータサイエンティストに転職は難しいだろうか（n回目）,14,0,89,231,https://twitter.com/dst_cogit_y2/status/1564282773216436225,14
1564259650970984448,umi_mori_jp,2022-08-29 14:32:17+00:00,【Python入門者向け | オライリー学習ロードマップ】1. Pythonによるデータ分析入門2. ゼロからはじめるデータサイエンス3. Pythonではじめる機械学習この順で学べば「理論と実践」の両軸で頼れるデータサイエンティストになれそう。ただ、これは鬼コースであり、本気の人にしか推奨できない。 https://t.co/Qw9fXpaICW,195,26,201,116,https://twitter.com/umi_mori_jp/status/1564259650970984448,221
1564206738483585024,pypy1225,2022-08-29 11:02:02+00:00,転職でデータサイエンティストを目指している方へ。「AIモデルを構築経験」等の専門性PRも大事ですが、結局「ビジネス的にどんな成果をどの程度生み出したのか」の方が大事。データ分析はあくまで手段でビジネス上の課題の解決が目的であることを忘れないように。#駆け出しエンジニアと繋がりたい,19,0,728,608,https://twitter.com/pypy1225/status/1564206738483585024,19
1564116555369422848,morris24grad,2022-08-29 05:03:41+00:00,🍖自己紹介🐟⚪️24卒⚪️旧帝大理系院 情報系研究科⚪️サークル○⚪️インターン✕⚪️データサイエンティスト志望情報収集にアカウント作成しましたゆくゆくは模擬面や壁打ちを一緒にできる方も探したいと思いますよろしくお願いします！#24卒 #24卒と繋がりたい,102,2,106,68,https://twitter.com/morris24grad/status/1564116555369422848,104
1564095332656394240,vloom_mario,2022-08-29 03:39:21+00:00,料理研究家とデータサイエンティストはとてもよく似ていて、素材（データソース）を見極め、レシピ（アルゴリズム）を考案・推敲し、人に喜んでもらう（社会の役に立つ）、クリエイティブなお仕事です。目指せデータ界のリュウジ。#バズレシピ #バズアルゴリズム,20,0,237,843,https://twitter.com/vloom_mario/status/1564095332656394240,20
1563953766449049601,vinumregum,2022-08-28 18:16:49+00:00,観測範囲内のiGEM関係者、博士課程進んでデータサイエンティストになる確率高い気がする（トカイワインはiGEMerではないです）,10,2,1132,319,https://twitter.com/vinumregum/status/1563953766449049601,12
1563849632362311680,pypy1225,2022-08-28 11:23:01+00:00,【混同されがちな職業の違いまとめ】データアナリスト(DA)：データ分析を基にビジネスへの応用・助言を行う。コンサルの作業者がこの立ち位置。データサイエンティスト(DS)：AIアプリ等分析モデルの構築を行う。DAよりも深い専門知識要。AIエンジニア：DSの作成したモデルを活用しAIアプリを製造。,16,1,728,608,https://twitter.com/pypy1225/status/1563849632362311680,17
1563820037106180097,satoshi28030166,2022-08-28 09:25:25+00:00,今日もドトールで統計の勉強中です🎵最近、とあるデータサイエンティストと話したのですが、採用面接で重要視するのは、実務経験のようです😃もちろん統計検定合格は評価して貰えますが、少し加点される程度なので、実務経験がある方は積極的にアピールすると良いですね🎵#統計#Python,12,0,165,77,https://twitter.com/satoshi28030166/status/1563820037106180097,12
1563782565563351040,mmpibot,2022-08-28 06:56:31+00:00,【自己紹介】🌅朝活🐹DWE🦁リベ大💪毎朝懸垂⏰時短勤務中👦🏻3人年子パパ👶🏻育休4ヶ月取得📝ストファイ1位学習欲💻ABCオンライン22年4月📊データサイエンティストの卵趣味は、#朝活！#ブログ！今は #データサイエンティスト を目指して勉強中です☺️気になればリプ&amp;フォローお願いします🥳,57,3,1000,822,https://twitter.com/mmpibot/status/1563782565563351040,60
1563696108232404993,kodenkoden,2022-08-28 01:12:58+00:00,転職の面接受けてるとプロフに書いてあるキャリアを見た面接官から「よくデータサイエンティストの部署へ異動できたね」と驚かれる。結果に結びつけて資格と希望をアピールして後は運。仕事で学んだことツィートしていきます。#仕事 #転職 #駆け出しエンジニアと繋がりたい #社会人,10,0,511,216,https://twitter.com/kodenkoden/status/1563696108232404993,10
1563524491157725184,sukeru_x3,2022-08-27 13:51:02+00:00,メンタル完全にやられた僕→データサイエンティストで一発逆転‼️まともな判断力できなくなってましたね、、、,14,0,693,243,https://twitter.com/sukeru_x3/status/1563524491157725184,14
1563520071880048646,Naoki_study_,2022-08-27 13:33:28+00:00,【今後の予定】・9/11 TOEIC800点越え・10/9 情報処理安全確保支援士試験合格以下順不同で片っ端にやる。・Pythonの勉強（AtCoderやりつつ）・データサイエンティスト検定・AWS、Azureの基礎資格・オンライン英会話（以下、当面諦めるものに続く）,14,0,136,228,https://twitter.com/Naoki_study_/status/1563520071880048646,14
1563425726270869504,UesugiYuko,2022-08-27 07:18:34+00:00,取得済◇TOEIC845◇VBA Expert (Excel/Access)Standard)◇FP2級◇日商簿記2級◇秘書検定2級◇データ分析実務スキル検定◇ビジネス統計スペシャリスト（エクセル分析スペシャリスト）◇Python3エンジニア認定データ分析◇データサイエンティスト検定　DS検定◇統計検定2級,40,0,82,15,https://twitter.com/UesugiYuko/status/1563425726270869504,40
1563389767060193281,ai_pc0210,2022-08-27 04:55:41+00:00,🐢先生機械学習講座前半セクション6の途中学習中最近はコンペなどで精度の高さばかり競われがちだけど解釈性の高い線形回帰で特徴量の関係やデータ考察する視点や分析も大事って言葉に目からうろこが。。😭　　色んな視点で考察できるサイエンティストになってAI開発柔軟にできるようになりたい,10,0,305,263,https://twitter.com/ai_pc0210/status/1563389767060193281,10
1563368242290122752,mrmzhts,2022-08-27 03:30:09+00:00,転職でデータサイエンティストやデータアナリストを目指している方へ。「XXモデルを使った」などの分析技法やアカデミックな自己PRも大事ですが、結局「ビジネス的にどんな成果をどの程度生み出したのか」の方が大事ですよ！示唆を出したからって現場が動くとは限りません！動かして成果出してナンボ！,49,4,271,573,https://twitter.com/mrmzhts/status/1563368242290122752,53
1563360382148055042,Yuiko43396068,2022-08-27 02:58:55+00:00,今やらなきゃいけないこと・学校の成績爆上げ・TOEFL単語帳残り4分の3・英文法総復習(nextage)・過去問とく・学生団体・Stanford e Japan申し込み準備・udemyデータサイエンス講座終了・CourseraのGoogleデータサイエンティストの資格とる時間の使い方の天才になりたい！,11,1,107,238,https://twitter.com/Yuiko43396068/status/1563360382148055042,12
1563356258203500546,VToshikuni,2022-08-27 02:42:32+00:00,So-gúd（ソウグウ）さんにPrepperに関するインタビュー記事を掲載いただきました！https://t.co/CMbo7eiYzR料理の鉄人も下準備はお任せしてましたよね？優秀なデータサイエンティストやアナリストが時間を使うべきはデータプレップではなくその先です。,11,2,353,316,https://twitter.com/VToshikuni/status/1563356258203500546,13
1563145407349198848,BioDr_Goro,2022-08-26 12:44:41+00:00,似非データサイエンティスト，はじめました https://t.co/GIzd7j0HWk,12,0,1666,375,https://twitter.com/BioDr_Goro/status/1563145407349198848,12
1563097260698640385,oki_kosuke,2022-08-26 09:33:22+00:00,データサイエンティストとして1年間働いて感じたことを記事にしました！・未経験からデータサイエンティストに転職するには？・実際に働いて感じたギャップ・大切だと感じた3つのこと#データサイエンティスト#転職 #Python #駆け出しエンジニアと繋がりたい https://t.co/LnatE9tH31,29,6,222,74,https://twitter.com/oki_kosuke/status/1563097260698640385,35
1563058724914475011,pyqjp,2022-08-26 07:00:14+00:00,2022年8月26日に日経BPより「独学コンピューターサイエンティスト」が発売されました。PyQとのコラボキャンペーンを公開したので紹介します。書籍「独学プログラマー」を執筆したコーリー・アルソフ氏の続刊となり、コラボ問題を含め、データ構造とアルゴリズムが学べます。https://t.co/qebOBGitl4,10,7,1142,24,https://twitter.com/pyqjp/status/1563058724914475011,17
1563051797278703618,rike_data_sci,2022-08-26 06:32:43+00:00,データサイエンティストを選んだ理由②変化が激しくても生き残れる人材になりたかったから👨‍💼「分析する力+IT人材=需要が高い」と思います🙌未来がどうなるかは分かりませんが、現時点ではこうかなと🤔#24卒 #23卒 #データサイエンティスト #就活 #就職活動 #駆け出しエンジニアと繋がりたい,16,1,128,26,https://twitter.com/rike_data_sci/status/1563051797278703618,17
1563047537572925441,mizuhoruisui,2022-08-26 06:15:47+00:00,弊社代表のインタビューが掲載されましたー！#prepper  #PODB「Prepper（プレッパー）」が実現する未来のデータ分析とは？データサイエンティストの可能性が、拡張される未来の話。 - So-gúd（ソウグウ） https://t.co/r4pKrujuDi,16,2,10,37,https://twitter.com/mizuhoruisui/status/1563047537572925441,18
1562996764625367040,mochi_24sotsu,2022-08-26 02:54:02+00:00,おそらくSE向いてないや。データサイエンティスト1本に絞るか。,12,0,428,376,https://twitter.com/mochi_24sotsu/status/1562996764625367040,12
1562916646510923777,e7sGHrvRHNYbmI0,2022-08-25 21:35:40+00:00,あべともこさんが横浜市長選挙でコロナの専門家として応援した現横浜市長の山中竹春（データサイエンティスト=科学者）の選挙ビラはこのようなものでしたが、医師であるあべともこさんも科学的根拠の無いことを喧伝して市民を騙したということでよい？ https://t.co/oQ9GUB5iA4 https://t.co/u0q0uV76pL,13,10,332,400,https://twitter.com/e7sGHrvRHNYbmI0/status/1562916646510923777,23
1562820277670912002,pegion_HOLE,2022-08-25 15:12:44+00:00,データ分析者のキャリア、コンサルやるか専門性を深めるかだと思うけど、後者でテーブルデータやるとなるとファイナンス領域に飛び込んでクオンツ兼データサイエンティストになるしかないかなぁ。ファイナンスはかなり特殊なのでもうしばらくは食っていけそう。むしろこれからかも。,11,0,951,798,https://twitter.com/pegion_HOLE/status/1562820277670912002,11
1564543456034164736,eeee_enoman,2022-08-30 09:20:02+00:00,データサイエンス未提出多すぎて落としたんだが,12,0,175,286,https://twitter.com/eeee_enoman/status/1564543456034164736,12
1564334738781147136,koudai02007,2022-08-29 19:30:40+00:00,おはようございます😊VPNを使うと、セキュリティの強化や海外のサイト、海外専用の映画などにアクセス出来るらしいですね😳今進めている『データサイエンス100本ノック』ではDockerを使っているけど、アクセス先が自分専用なんだろうか🤔だとしたら、すごい技術だな😳,16,0,406,462,https://twitter.com/koudai02007/status/1564334738781147136,16
1564291632517656576,garlopera,2022-08-29 16:39:22+00:00,未経験でデータサイエンスの転職むずいな。〇〇経験数年以上みたいなのがネック。,17,1,145,217,https://twitter.com/garlopera/status/1564291632517656576,18
1564277904589983744,garlopera,2022-08-29 15:44:49+00:00,文系出身の社会人がデータサイエンス業界に転職したくなったらどうするのが良いんだろう。未経験でも新卒なら入れるところあっかもだけど、中途採用だと難しいよね。。,18,1,145,217,https://twitter.com/garlopera/status/1564277904589983744,19
1564259650970984448,umi_mori_jp,2022-08-29 14:32:17+00:00,【Python入門者向け | オライリー学習ロードマップ】1. Pythonによるデータ分析入門2. ゼロからはじめるデータサイエンス3. Pythonではじめる機械学習この順で学べば「理論と実践」の両軸で頼れるデータサイエンティストになれそう。ただ、これは鬼コースであり、本気の人にしか推奨できない。 https://t.co/Qw9fXpaICW,195,26,201,116,https://twitter.com/umi_mori_jp/status/1564259650970984448,221
1564240150217236481,yocajii,2022-08-29 13:14:48+00:00,#放送大学 卒業認定されました🙌あと科目群履修認定制度で「計算機科学の基礎」、「データサイエンス」、「人にやさしいメディアのデザイン」の認証状も取れました。やった〜 https://t.co/B3ZYK5MsNu,22,0,195,105,https://twitter.com/yocajii/status/1564240150217236481,22
1564227742950096897,ken91tee,2022-08-29 12:25:30+00:00,【Tableau日記29日目】[Tableau極める Day5]FIXED関数を使い、平均購入間隔を求めました。LOD表現使いこなしたい👀[データサイエンス本]今日は決定木モデルを作成し、graphvizで可視化しました！最適なパラメータをグリッドサーチで探すの楽しい😇#Tableau #Tableau極める https://t.co/iGLgmSJD1l,12,0,131,97,https://twitter.com/ken91tee/status/1564227742950096897,12
1564188450727038977,jue_fukuoka,2022-08-29 09:49:22+00:00,本学で提供している教育プログラムが、文部科学省の『数理・データサイエンス・ＡＩ教育プログラム認定制度（リテラシーレベル）』 の認定を受けました（認定期限は令和９年３月31日まで） 。本学では文科省認定の本教育プログラムを全ての学生が受けることができます。  https://t.co/8m3qcbcqNp https://t.co/emd0xwBFWl,18,4,981,133,https://twitter.com/jue_fukuoka/status/1564188450727038977,22
1564185606049222657,surpass19b,2022-08-29 09:38:04+00:00,AWS SAA取ったのでしばらくは認定試験からは離れたい😂だけどいずれはML・データサイエンス系のAWSプロフェッショナル資格も目指したいなー！どれがおすすめなんだろか🤔#プログラミング初心者#駆け出しエンジニアと繋がりたい,24,0,470,250,https://twitter.com/surpass19b/status/1564185606049222657,24
1564118851742466050,hl_tsukamoto,2022-08-29 05:12:48+00:00,戦術で勝つ！…と、いう話は面白いですよね。最近はデータサイエンスが進んでいるから如実にそれが出てきていて興味深い。バスケの常識覆す3点シュート　女子五輪銀、NBAに学ぶ：日本経済新聞https://t.co/LKD0WebhQr,26,0,1680,3292,https://twitter.com/hl_tsukamoto/status/1564118851742466050,26
1564005349257932800,koudai02007,2022-08-28 21:41:47+00:00,おはようございます😊今日は、『データサイエンス100本ノック』を進めます💪それと、開発したいものがあるので、調べながらやってみます💪今週も頑張ろう😊,17,0,406,462,https://twitter.com/koudai02007/status/1564005349257932800,17
1563912312222019585,isa_tused_22374,2022-08-28 15:32:05+00:00,生命科学入門…／現代物理学概論…C中国語…BL&amp;S…BR&amp;W…Bミクロ…Aマクロ…Bデータサイエンスの基礎…C会計学…Aマーケティング…C微積分…S線形代数…A確率統計…AGPA…2.24(小数第3位四捨五入),22,5,613,715,https://twitter.com/isa_tused_22374/status/1563912312222019585,27
1563860823092539393,datadrivenlove,2022-08-28 12:07:30+00:00,データサイエンス系インターンで活躍する方法 #note #就活体験記 #駆け出しエンジニアと繋がりたい #24卒 #就活 #データサイエンティスト #データサイエンス #インターン  #就活生と繋がりたい #転職活動https://t.co/zEkYkd0Xxj https://t.co/mZyYCzd7N2,18,3,319,270,https://twitter.com/datadrivenlove/status/1563860823092539393,21
1563837205935640576,Skipper75972590,2022-08-28 10:33:39+00:00,何回も言ってるけどアメリカは核兵器を使う気でいる使いたいという欲望を抑えきれていない中東はデータ収集やデモンストレーションにはうってつけの場所だ日経サイエンス　 2005年1月号地下攻撃核ミサイルに異議ありM.レビ（ブルッキングス研究所）https://t.co/khfJcQfz7y https://t.co/5mwQaCS7pu,10,5,678,46,https://twitter.com/Skipper75972590/status/1563837205935640576,15
1563760963224244226,ugubgBUy9Mg2cVF,2022-08-28 05:30:41+00:00,@AA4yfwrsEEND6s7 @kutsunasatoshi 英国やカナダやドイツなどではデータを公表してたのですが、接種者がマイナス効果になり非公表にしました。日本も同様に統計手法を弄ります。サイエンス掲載論文では、英国の研究チームがワクチン＝感染拡大と発表しました。ワクチンはtーreg活性化やlgG4活性化により人体の防御機能を壊します。,22,1,41,80,https://twitter.com/ugubgBUy9Mg2cVF/status/1563760963224244226,23
1563759797463584768,ugubgBUy9Mg2cVF,2022-08-28 05:26:03+00:00,@PzK7NSelgv46a6Q @kutsunasatoshi ①ありません。多くの国家データでマイナス効果です。サイエンスにもワクチン接種＝感染拡大の論文も掲載されました。②そもそも論でワクチン抗体自体の効果は不明どころか上記の件含めなんの根拠もありませんこれらが現実です。,182,2,41,80,https://twitter.com/ugubgBUy9Mg2cVF/status/1563759797463584768,184
1563709248181522432,moriwell,2022-08-28 02:05:11+00:00,European Actuarial Academyとactuviewが共同で開催するオンライン大会Convention Aでスピーカーをします！内容はアクチュアリー会のデータサイエンスWGの研究成果である予測誤差の分解についてです！海外のアクチュアリーに日本の活動が伝えられたら良いなと思います！https://t.co/h6FAfGqQd7,10,1,825,806,https://twitter.com/moriwell/status/1563709248181522432,11
1563508588248608768,vloom_mario,2022-08-27 12:47:50+00:00,データサイエンスの領域は色々あれど、ユーザーデータや時系列データを扱うならPythonよりSQLを習得することをオススメします。最近のBigQueryやRedshiftはML機能まであるので、Python中級者レベルくらいまでで出来ることの多くはSQLでできます。そして何より速い。#駆け出しエンジニアと繋がりたい,30,1,237,843,https://twitter.com/vloom_mario/status/1563508588248608768,31
1563504900554002433,ken91tee,2022-08-27 12:33:11+00:00,【Tableau日記27日目】[Tableau極める Day3]土日を除くという計算をCASE文で作成しました✏️条件分岐をゼロから作るには訓練が必要ですね…＞＜[Tableauで始めるデータサイエンス]機械学習の基本ということで環境構築とJupyter Notebookを生まれて初めて起動しました😎#Tableau #Tableau極める https://t.co/z59ycKlKdS,15,1,131,97,https://twitter.com/ken91tee/status/1563504900554002433,16
1563466404044902401,datadrivenlove,2022-08-27 10:00:13+00:00,【データサイエンスって結局なんなのか】あらゆるデータサイエンス系インターンに参加して最終的に思ったこと #note #就活体験記 #駆け出しエンジニアと繋がりたい #24卒 #就活 #データサイエンティスト #データサイエンス #インターン  #就活生と繋がりたい #転職活動 https://t.co/n5tTdlPD2M,17,0,319,270,https://twitter.com/datadrivenlove/status/1563466404044902401,17
1563440205935550464,go_over_Neumann,2022-08-27 08:16:07+00:00,僕は研究系の副拠点長になる予定です。データサイエンスの面から、ワクチン開発を加速できるように頑張ります！,18,0,1133,399,https://twitter.com/go_over_Neumann/status/1563440205935550464,18
1563431413419876352,TakabotGo,2022-08-27 07:41:10+00:00,未経験でもテックアカデミーのデータサイエンスコースで挫折せずに習得できた理由とは？ https://t.co/hWcIeqg2ph #駆け出しエンジニアと繋がりたい#プログラミング初心者,19,1,169,122,https://twitter.com/TakabotGo/status/1563431413419876352,20
1563408898031120384,Rissho_DS,2022-08-27 06:11:42+00:00,立正大学データサイエンス学部が文科省の認定・選定する「数理・データサイエンス・ＡＩ教育プログラム認定制度（応用基礎レベル）」に学部・学科単位で認定されました！https://t.co/YM71T1oXd2,13,2,145,11,https://twitter.com/Rissho_DS/status/1563408898031120384,15
1563406970295824384,UesugiYuko,2022-08-27 06:04:03+00:00,統計検定のデータサイエンス発展はどうやって勉強したらいいんでしょうか？https://t.co/5LxaYhhDOK#統計検定#データサイエンス発展#DS発展,10,0,82,15,https://twitter.com/UesugiYuko/status/1563406970295824384,10
1563360382148055042,Yuiko43396068,2022-08-27 02:58:55+00:00,今やらなきゃいけないこと・学校の成績爆上げ・TOEFL単語帳残り4分の3・英文法総復習(nextage)・過去問とく・学生団体・Stanford e Japan申し込み準備・udemyデータサイエンス講座終了・CourseraのGoogleデータサイエンティストの資格とる時間の使い方の天才になりたい！,11,1,107,238,https://twitter.com/Yuiko43396068/status/1563360382148055042,12
1563329813821407239,emc_students,2022-08-27 00:57:27+00:00,本日は有明でのオープンキャンパスです！学生同士の交流会などでお世話になっている、データサイエンス学部@DS_Musashinoのご厚意で5号館の1階に武蔵野EMC用のブースをお借りしました！😭EMCからは1年生が設営のお手伝いとしてお邪魔しております！ぜひ遊びに来てください〜！#武蔵野EMC https://t.co/sCTeTWnGBd,17,6,232,70,https://twitter.com/emc_students/status/1563329813821407239,23
1563272246751555584,susono333,2022-08-26 21:08:42+00:00,この土日、自宅で研究費申請書を書き、放送大学２学期受講科目申告の修正をする。１０月からの土日の予定もわかってきたので、面接授業は減らすつもり。オンライン授業もたくさん取ると消化不良になるので、データサイエンス以外をどうするか考えよう。,11,0,373,186,https://twitter.com/susono333/status/1563272246751555584,11
1563124934888411138,naokima_english,2022-08-26 11:23:20+00:00,ウイスキーへの愛を成仏させるためにウイスキー検定を受けたいが、通訳訓練をもっとやりたいし、医療統計を広げてデータサイエンスもやりたいし、他にも色々あるのでput on the back-burnerです😭いつか取ってやる🔥🥃🔥🥃🔥,21,0,541,265,https://twitter.com/naokima_english/status/1563124934888411138,21
1563035410053595137,susono333,2022-08-26 05:27:36+00:00,図書館で統計の本を借りてきた。定年退職する前でデータサイエンスの力を付けたい。放送大学で藤井先生が担当する「統計学」では第１回に「医療データ」の統計の話があった。娘が医療データを分析し論文を書くのに数年後役立つかもしれない。 https://t.co/2h8DNBApSk,18,1,373,186,https://twitter.com/susono333/status/1563035410053595137,19
1562980381481369601,dsGathering_vrc,2022-08-26 01:48:56+00:00,昨日のデータサイエンス集会内LTで「よく因果推論って聞くけどどういう内容なの？」というテーマで数式なし入門者用を観点に発表いたしました😋😋😋twitter用に冒頭だけ切り抜き載せますが、フル版は以下のYoutubeから観れますーhttps://t.co/038qxFPlpc発表スライドはリプツリーにて！ https://t.co/Y08WD4gfx9,46,10,153,4,https://twitter.com/dsGathering_vrc/status/1562980381481369601,56
1562961539392753664,bebebeBayes,2022-08-26 00:34:04+00:00,全く悪いことじゃないが、｢データサイエンス入門シリーズ｣は難易度にバラツキがある。『スパース回帰分析とパターン認識』『モンテカルロ統計計算』『Rで学ぶ統計的データ解析』『統計モデルと推測』が好みだが、挙げた順にレベルが高い。ただ本の中でのレベル感には纏まりがあっていいシリーズ。,75,7,1331,338,https://twitter.com/bebebeBayes/status/1562961539392753664,82
1564292598361358336,TAMO_APP,2022-08-29 16:43:13+00:00,絵師やクリエイターは日本の文化的な側面を担ってるから、そこを損なうのは国としても良くないだろうし、お上がどう判断するか気になる技術経済を取るか、文化を取るか#例のAI #著作権侵害 #行政書士#駆け出しエンジニアと繋がりたい#AI#人工知能#イラストレーター#mimic#クールジャパン,10,0,35,4,https://twitter.com/TAMO_APP/status/1564292598361358336,10
1564019474776600576,yankii_hitsuji,2022-08-28 22:37:55+00:00,「脳トレ健康Ch」毎日２回投稿挑戦中🥳今日の朝の部はこちら～！！きゃわゆい少女のイラストをAIに描いてもらって、間違い探し用に編集しました♪#イラスト #AI #人工知能 #midjourney #絵 #YouTube #YouTuber #脳トレ #間違い探し https://t.co/g1R3NFW3AX https://t.co/HiP17yHjhO,17,3,449,518,https://twitter.com/yankii_hitsuji/status/1564019474776600576,20
1563792080912101377,tadataka_s,2022-08-28 07:34:20+00:00,こちらの映像は小川倫生さんが撮影した写真と動画を元に、人工知能を駆使したエフェクトを加えました。人工知能というと、冷たい幾何学的なイメージを連想しがちですが、使い方次第で有機的な暖かいイメージも産まれるのが面白い。#人工知能 #artomaton https://t.co/CPbJymXlNI https://t.co/4RcBpRogSi,11,2,585,337,https://twitter.com/tadataka_s/status/1563792080912101377,13
1563149273843187712,aoi_studyai,2022-08-26 13:00:03+00:00,👇今日の気になるAIニュースポケモンのデータで”Python”を学ぶhttps://t.co/HkRm24cpNw可愛いポケモン達のデータを使いながら、楽しく学べます☺️💻Pythonを始めてみたい方におすすめです✍️✨#AI #人工知能 #Python #ポケモン #駆け出しエンジニアと繋がりたい,30,3,1906,1426,https://twitter.com/aoi_studyai/status/1563149273843187712,33
1562799285284270080,haposaisai,2022-08-25 13:49:19+00:00,AIで画像生成する #stablediffusion を試しに使って、指定した画像(右)から新しい画像(左)を生成しました♬プロンプトの書き方がよくわからなかったので「ハムスター」とだけ入力したら、マイクからハムスターみたいなものが飛び出す怪しい画像ができましたw #Img2Img #AI #機械学習 #人工知能 #写真 https://t.co/gQu3V23ThM,41,4,1459,1391,https://twitter.com/haposaisai/status/1562799285284270080,45
1562793100959174657,puppypetsachi,2022-08-25 13:24:45+00:00,マークシートを開発した会社のようです。#堺市　#人工知能 https://t.co/qd0YVpMz45,32,0,1258,2966,https://twitter.com/puppypetsachi/status/1562793100959174657,32
1562726484791349253,aoi_studyai,2022-08-25 09:00:02+00:00,👇今日の気になるAIニュース「人気プログラミング言語2022」が発表されるhttps://t.co/0VXuTGRkYpSpectrum / Jobs / Trending、3パターンでの集計結果を確認できます。Pythonはどの集計でもTOP3入りしています🎉✨#AI #人工知能 #機械学習 #python #駆け出しエンジニアと繋がりたい,13,0,1906,1426,https://twitter.com/aoi_studyai/status/1562726484791349253,13
1562620782907641856,HIKARI_User01,2022-08-25 02:00:01+00:00,こんにちは☀︎ ᙏ̤̫ ஐ今日もHAPPYに過ごせるように誕生月別メッセージ［今日の誕生月占い］を5時55分に配信しました⭐︎＃はてなブログ ＃タロット ＃ルノルマン ＃龍神カード ＃メッセージ ＃追求 ＃人工知能 ＃五感 ＃せせらぎhttps://t.co/paAzOj8XJx,25,1,812,765,https://twitter.com/HIKARI_User01/status/1562620782907641856,26
1562582245667635201,tabi__chu,2022-08-24 23:26:53+00:00,Weekly theme: The grim reaper.今週のテーマ: 死神Le thème de la semaine: le grande faucheuse.#ai #aiart #midjourney #grimreaper #death #imagery #symbol #midjouneyart #midjourneyaiart #aiartworks #lafaucheuse #mort  #virtuel #virtual #死神 #人工知能 #アート #cute #digitalart https://t.co/3j0lFmdBW1,5,0,2,3,https://twitter.com/tabi__chu/status/1562582245667635201,5
1562424492378447872,aoi_studyai,2022-08-24 13:00:02+00:00,👇今日の気になるAIニュース【Python】seabornで綺麗なグラフ作成を！たった1行で書けますhttps://t.co/96H5GcWq00Pythonでのグラフの書き方について、初心者🔰向けに分かりやすくまとめられています📚✨#AI #人工知能 #機械学習 #python #駆け出しエンジニアと繋がりたい,13,1,1906,1426,https://twitter.com/aoi_studyai/status/1562424492378447872,14
1562215898492338177,reading_earth,2022-08-23 23:11:09+00:00,#駆け出しエンジニアと繋がりたい#人工知能#AI教師あり学習英語翻訳教師なし学習売上データによる客層予測,18,2,545,381,https://twitter.com/reading_earth/status/1562215898492338177,20
1561337329310130178,aoi_studyai,2022-08-21 13:00:02+00:00,👇今日の気になるAIニュース[MangaRestoration] 漫画のスクリーントーン特化型超解像AIを動かすhttps://t.co/w1vRHS1p8m画質の悪い漫画を復元する方法について、ソースコード＆実装方法が分かりやすく記載されています📚✨#AI #人工知能 #機械学習 #Python #駆け出しエンジニアと繋がりたい,19,0,1906,1426,https://twitter.com/aoi_studyai/status/1561337329310130178,19
1564577648268828673,lan_java,2022-08-30 11:35:54+00:00,太閤立志伝Ⅴ　THE盗賊メインイベントの一つ「路上強盗」が完成長年の夢であった「路上（フィールド上）でのみ強盗ができる」をようやく形にできた勲功＝所持金なので、身分の高い人ほど奪える金額が多いまた相手が価値五以上のアイテムを保有していると、奪う事が出きるようになる https://t.co/xtCo5yO0Ij,21,8,1489,767,https://twitter.com/lan_java/status/1564577648268828673,29
1564569798901907456,java_0512,2022-08-30 11:04:43+00:00,超絶カメラ目線 https://t.co/comZcRo50c,10,0,542,668,https://twitter.com/java_0512/status/1564569798901907456,10
1564543691015856128,DreamFrontier88,2022-08-30 09:20:58+00:00,さて、今夜も電車の中でJavaの勉強しますか‼️自分自身の成長に向けて打ち込めるって素晴らしい✨#Java#プログラミング初心者と繋がりたい #勉強チャレンジ #駆け出しエンジニアと繋がりたい,12,0,25,25,https://twitter.com/DreamFrontier88/status/1564543691015856128,12
1564530864964284416,uha_blog,2022-08-30 08:30:00+00:00,【 #Java のフレームワーク】・Spring Framework・Jakarta EE・Apache Struts・Apache Wicket・Play Framework・JSF（JavaServer Faces）#駆け出しエンジニアと繋がりたい #プログラミング初心者,12,0,113,93,https://twitter.com/uha_blog/status/1564530864964284416,12
1564527546410352640,dang_mug,2022-08-30 08:16:49+00:00,@effle_lee 我喝 Java https://t.co/xNpD214eAS,19,1,117,299,https://twitter.com/dang_mug/status/1564527546410352640,20
1564515925172203522,chaco_yukkuri,2022-08-30 07:30:38+00:00,今日のショートは、JAVA版と統合版のエンダーマンはこんなにちがう🍵#マイクラ#茶子ゆっくり#YouTubeショート https://t.co/pdzEcQnG3S,21,1,995,67,https://twitter.com/chaco_yukkuri/status/1564515925172203522,22
1564499029345505280,vetlanprogramer,2022-08-30 06:23:30+00:00,Railsエンジニアの年収は安い。３５０万くらいだろう。駆け出しは　東京限定で求人は少ない　Web系くらいしか使っていない。大手の企業はみんなJavaやC#　あとpythonだろう。 38   #駆け出しエンジニアと繋がりたい,23,1,184,0,https://twitter.com/vetlanprogramer/status/1564499029345505280,24
1564487899005210624,yuyutasmile,2022-08-30 05:39:16+00:00,【プログラミング学習のProgate】Javaのレベルが38にUPしました！ https://t.co/L47XHGU9LX #Progate,10,0,712,770,https://twitter.com/yuyutasmile/status/1564487899005210624,10
1564486561886257152,tamatama011165,2022-08-30 05:33:57+00:00,web制作やJavaやPHPなどの初心者向け案件あれば教えていただきたいです。#web制作#ホームページ制作#ホームページ#web#Java#PHP #プログラミング#案件,11,1,63,146,https://twitter.com/tamatama011165/status/1564486561886257152,12
1564481944913448960,lan_java,2022-08-30 05:15:36+00:00,ダブー中のダブーに触れやがった…！まるで江戸時代に籾摺り機が登場したとき「後家ごろし」と言われて、農家の奥さんたちが「あたし達をころすきか！」と、ぶっ壊したのと似ている…！だ、なんて話、思っていても言わなかったのに…！ https://t.co/XJ3Ck7hfKz,39,29,1489,767,https://twitter.com/lan_java/status/1564481944913448960,68
1564466768831479808,tokyo_polinky,2022-08-30 04:15:18+00:00,"Level 42 ""Something About You"" live at Java Jazz Festival 2016 https://t.co/AmfW16YpU1 Level42 来日公演、いよいよ明日スタート！",14,2,654,906,https://twitter.com/tokyo_polinky/status/1564466768831479808,16
1564463216133935110,dx_daiji,2022-08-30 04:01:11+00:00,JavaとJavaScriptは別物だけどJava理解できるならJavaScript分かるよ#駆け出しエンジニアと繋がりたい,12,0,28,89,https://twitter.com/dx_daiji/status/1564463216133935110,12
1564462086264332290,ria__minecraft,2022-08-30 03:56:42+00:00,・寝る・YouTube見る・JAVAで建築する・ゆるサバで遊ぶ・昨日のアスレの続きする・寝るさあどれしよう🤔,19,0,492,125,https://twitter.com/ria__minecraft/status/1564462086264332290,19
1564455428737859586,Java_Meal2,2022-08-30 03:30:15+00:00,これマジでそうだった https://t.co/Gu7ugnfQIb https://t.co/2ulsv2ZxoE,29,0,1617,448,https://twitter.com/Java_Meal2/status/1564455428737859586,29
1564454318220406786,Java_Meal2,2022-08-30 03:25:50+00:00,なんか　梅宮辰夫って白目が肌色だった気がする,19,1,1617,448,https://twitter.com/Java_Meal2/status/1564454318220406786,20
1564452123236274176,Caryll_Liese,2022-08-30 03:17:06+00:00,おはようございます本日は、21時からマイクラ(Java版)の配信をやりますそれでは、今日も一日頑張りましょう #おはようVTuber https://t.co/XPpVRhuEQd,22,1,237,232,https://twitter.com/Caryll_Liese/status/1564452123236274176,23
1564443037413015552,NoticeperiodCom,2022-08-30 02:41:00+00:00,8/30【Instagram更新】随時最新の案件情報を掲載しています💁‍♀️是非ご覧ください！https://t.co/A0olwCNAFx#Java #Python #SQL #AWS #リモート #在宅ワーク #転職 #エンジニア転職 #駆け出しエンジニアと繋がりたい #企業公式相互フォロー #企業公式夏のフォロー祭り#ses #フリーランス,40,3,143,82,https://twitter.com/NoticeperiodCom/status/1564443037413015552,43
1564442657295740929,NGY_it_anken,2022-08-30 02:39:30+00:00,8/30【Instagram更新】随時最新の案件情報を掲載しています💁‍♀️是非ご覧ください！https://t.co/40DmULeEeQ#Java #Python #SQL #AWS #リモート #在宅ワーク #転職 #エンジニア転職 #駆け出しエンジニアと繋がりたい #企業公式相互フォロー #企業公式夏のフォロー祭り#ses #フリーランス,20,2,656,672,https://twitter.com/NGY_it_anken/status/1564442657295740929,22
1564440556389879815,lan_java,2022-08-30 02:31:09+00:00,@_ss939 @Nanaio627 この世界には重大なバグがあります。修正が必要です。,20,1,1489,767,https://twitter.com/lan_java/status/1564440556389879815,21
1564438789988429825,s_abe_all,2022-08-30 02:24:08+00:00,Java1年生でもいけるJava案件あれば、DMかラインお待ちしております🙇‍♂️※このツイートにリプはいらないです！,12,3,1998,995,https://twitter.com/s_abe_all/status/1564438789988429825,15
1564438004285902848,lan_java,2022-08-30 02:21:00+00:00,これの問題は「AI学習させる」ことよりも、学習させた結果のイラストを、会社が無断で商品にするのでは無いか？あるいは第三者が勝手に商品として売り出すのでは無いか？っていうことだと思うんスよね…でも、これを騒ぎ立てて潰すと、著作権の概念の無い中国あたりが大勝利になるのが色々と酷い… https://t.co/BffGz46Lsn,13,1,1489,767,https://twitter.com/lan_java/status/1564438004285902848,14
1564435358670274561,namber_h_,2022-08-30 02:10:29+00:00,Udemyセールやってますね！何か買おうかなーJavaかJavaScript買おうかな🤔#駆け出しエンジニアと繋がりたい,57,0,68,54,https://twitter.com/namber_h_/status/1564435358670274561,57
1564424535797288961,Java_Meal2,2022-08-30 01:27:29+00:00,エイアイ？に仕事を取られるだと？　大丈夫　自民党様が守ってくださるだろう　農家や判子屋も自民党様が守っておるのだ　おまえもきちんと祀れば　守ってくださるだろう　そのエイアイン？という外国人も　追い出してくださるだろう,74,4,1617,448,https://twitter.com/Java_Meal2/status/1564424535797288961,78
1564411814267555840,programmer_cg,2022-08-30 00:36:56+00:00,もう少しで８月も終わりですね😳勉強が捗らなかったという方スクールも検討してみませんか？当社はプログラミングと就活支援に加えiパスとJava資格取得無料のキャッシュバック制度あり✌まずは説明会へ※本日参加可↓https://t.co/rW3sSN9a1R#プログラミング初心者 #駆け出しエンジニア https://t.co/78xPV8pJVf,10,0,1489,2903,https://twitter.com/programmer_cg/status/1564411814267555840,10
1564408533034053632,kyooooonaka,2022-08-30 00:23:54+00:00,おはようございます😃今日も一日頑張っていきましょう！有給を取ったので、今日はガッツリと勉強出来そうです。#Java #エンジニアと繋がりたい #プログラミング学習,11,0,258,293,https://twitter.com/kyooooonaka/status/1564408533034053632,11
1564399904948383744,ResearchInField,2022-08-29 23:49:37+00:00,Javaについて、特にどれに興味をひかれますか？　「その他」の場合は、ご興味のあるテーマをツイートしてくださると幸いです。＃駆け出しエンジニアと繋がりたい＃SE ＃エンジニアと繋がりたい ＃プログラマ ＃ITエンジニア ＃プログラミング初心者,22,0,5,127,https://twitter.com/ResearchInField/status/1564399904948383744,22
1564350639140110336,ryu_itkensa,2022-08-29 20:33:51+00:00,#朝活おはようございます☀[今日の学習]✔︎Java silver✔︎toeic 文法問題今日も一日頑張っていきましょう📚,14,0,124,134,https://twitter.com/ryu_itkensa/status/1564350639140110336,14
1564305080941027328,minami_mizuan,2022-08-29 17:32:49+00:00,統合版練習お疲れ様でした〜Java版と統合版てこんなに違うんやねえ！新鮮でした！✨色々経験出来てよかったね！本番に向けてふぁいとです🔥イントネーション難しいね😂タキシード？サム！がお気に入りです🤣💗遅くまで配信ありがとうございました🎶ゆっくり休んでね💫#こんちゃっちゃ,24,0,281,447,https://twitter.com/minami_mizuan/status/1564305080941027328,24
1564303887976525824,Java_Meal2,2022-08-29 17:28:04+00:00,百姓が頑張って培った技術が　別に機械でできますよね　ということになる　ズルだと言って百姓が怒る　新世代の百姓はそれを尻目に　その機械を前提として新しい技術を培う　しかしそれもすぐに機械でできるようになる　ズルだと言って百姓が怒る　このようなことが常に繰り返されてきたのである,103,11,1617,448,https://twitter.com/Java_Meal2/status/1564303887976525824,114
1564303765817425920,guilitysong,2022-08-29 17:27:35+00:00,統合版とJava版だと違いが多いなぁー(*´꒳`*)勉強になるしポジティブに考えるの好きだなーおらふくん練習ふぁいとー٩(๑òωó๑)۶タキシード・サム言えるようになりますように🤣🤣#こんちゃっちゃ,12,0,195,366,https://twitter.com/guilitysong/status/1564303765817425920,12
1564289184629669890,rion_oxu,2022-08-29 16:29:39+00:00,いまから鯖で配信します!マイクラJava版ですが!,15,0,824,954,https://twitter.com/rion_oxu/status/1564289184629669890,15
1564277184549703680,Umi_to_Hitsuji,2022-08-29 15:41:58+00:00,"爪哇島スムベルラワン（Java, Sumberlawang）の羊。画像では判じ難いが、ヘアっぽい毛を纏って見える。ジャワ島西部にはプリアンガン（ガルート）という闘羊・肉用種がいるそうだが、あれだろうか。背景の竹柵が東南アジア風。闘羊、現地で見てみたい。子安農園家畜研究会『家畜』8(6)より… #sheep https://t.co/WC4Wd27PX6",12,1,504,842,https://twitter.com/Umi_to_Hitsuji/status/1564277184549703680,13
1564275222441648128,gabogabo0414,2022-08-29 15:34:10+00:00,Java版でマイクラマルチするの初めてだったけどmakiさんに要介護されながらもwなんとかできたしまさかの出会いもあったので今夜はいい夢みれそうだ💤,24,0,292,254,https://twitter.com/gabogabo0414/status/1564275222441648128,24
1564574945840992256,watch_dog_timer,2022-08-30 11:25:10+00:00,mimicからβ版停止と不正利用対策の案内が出されたが至極真っ当な姿勢。しかしこの件で海外に遅れるという意見が散見されるが、プラットフォーム競争j時代に考えるべきは機械学習の一アルゴリズムを競う事ではなく、類似検索と著作物判定のような「仕組み」の方。そういう議論全然されないよね… https://t.co/113VRvYhhZ,17,9,1148,1265,https://twitter.com/watch_dog_timer/status/1564574945840992256,26
1564570540337049600,tokyoalgorithm,2022-08-30 11:07:39+00:00,秋の河口湖～柳家スーパーフェスに出演決定‼️10/29、30河口湖キャメロットうちは10.29に出演10/29(土)13時〜柳家睦とラットボーンズジゴロ13アンガーフレアーズスマッシュ・ユア・フェイス東狂アルゴリズムオールディックフォギーグレートインベーダーズ&amp;全国バンド物販多数！,10,3,1809,258,https://twitter.com/tokyoalgorithm/status/1564570540337049600,13
1564568617265479680,Karasu_2036,2022-08-30 11:00:01+00:00,いいね・コメントはすればするほどアルゴリズム的には良いだけど読まずにいいねしたり、中身のないコメントするのは違うと思うあなたがされて嬉しくないことは相手も嬉しくない😠#ブログ #blog #ブログ初心者 #ブログ初心者と繋がりたい #ブログ仲間と繋がりたい #ブログ仲間募集中 #ブログ書け,15,1,1027,106,https://twitter.com/Karasu_2036/status/1564568617265479680,16
1564543541682257920,nursecopywriter,2022-08-30 09:20:22+00:00,@afilasite アフィラさん　twitterのアルゴリズムのこともありますが、何よりたのしさやつながりを感じられることって他になかなか味わえない😄だからみんな続くんだと思います(๑&gt;◡&lt;๑)ビジネスで一番大事なコツコツ続けることを教えてくださりありがとうございます😊,12,0,324,287,https://twitter.com/nursecopywriter/status/1564543541682257920,12
1564539796336553989,kenken_patent,2022-08-30 09:05:29+00:00,アルゴリズムの簡単な参考書が欲しいと思って、古本で安く売ってた↓の本をポチったけど、内容は定評あるようだが、この｢はわわ～｣なイラストってジャマくさいわ～😅#駆け出しエンジニアと繋がりたい https://t.co/shFoHgF8Vb,15,0,1646,1253,https://twitter.com/kenken_patent/status/1564539796336553989,15
1564539027050487808,daigolog,2022-08-30 09:02:26+00:00,先日のアルゴリズムが変わった辺でぼくのTLに表示される傾向もちょっと変わったんですが、改めてトピックを幾つかクリックしたらお好みのものにガラッと変わった気がする🤗これで新たなNFT作品を沢山いいねできそうです✨😆,16,0,860,863,https://twitter.com/daigolog/status/1564539027050487808,16
1564527164816470017,oshito_i,2022-08-30 08:15:18+00:00,アルゴリズムのせいなのか全然ツイートが表示されない人とかリプが来てても通知されないケースもあるなんでや,11,0,918,335,https://twitter.com/oshito_i/status/1564527164816470017,11
1564516727823933440,rino_horai,2022-08-30 07:33:49+00:00,Facebook 投稿にも普段あまり表示されない札幌の人や札幌にいる投稿ばかりが上がってくるようになった。凄いアルゴリズムだなー☺️,12,0,1642,1376,https://twitter.com/rino_horai/status/1564516727823933440,12
1564497928617529345,hayaoshitorenai,2022-08-30 06:19:07+00:00,しかし新城に暇してる仲間がいるのになぜ中原にいる自分に新城の加盟店ピックが飛んでくるのか🤔🥫の新アプリのアルゴリズムの解析出来る方、教えてちょーだい😤,10,0,246,210,https://twitter.com/hayaoshitorenai/status/1564497928617529345,10
1564477209922109440,queenemiko5,2022-08-30 04:56:48+00:00,Twitterアルゴリズム変更だとかでご無沙汰のffさん増えたよね…なんか寂しいなぁ元に戻してもらえないかなぁ,26,0,378,385,https://twitter.com/queenemiko5/status/1564477209922109440,26
1564474217709858816,SULLIVA09943379,2022-08-30 04:44:54+00:00,雑記ガールズだのとうふアンチだのという恥ずかしい人達が、別種の恥ずかしい人達と争ってるっぽいのがTLでクソ流れてくる。アルゴリズムどうなってんだ。,23,5,1028,979,https://twitter.com/SULLIVA09943379/status/1564474217709858816,28
1564451591687741442,Karasu_2036,2022-08-30 03:15:00+00:00,アルゴリズムは「フォロワーを増やすための条件」やと考えたほうが良いなぜなら条件を満たしてもフォロワーが増えるわけじゃないから満たした上で有益な情報を発信するのが正解😊#ブログ #blog #ブログ初心者 #ブログ初心者と繋がりたい #ブログ仲間と繋がりたい #ブログ仲間募集中 #ブログ書け,38,1,1027,106,https://twitter.com/Karasu_2036/status/1564451591687741442,39
1564446593666908160,yosuke_crypto,2022-08-30 02:55:08+00:00,最近のTwitterアルゴリズム変更により、フォロワー以外にもリーチを広げる必要があると判断よって名前とプロフ文を変更仮想通貨ブロガーでなくブロガー＆マーケターであることを強調し、幅広いターゲットに刺さるプロフ文に変更しましたこれで伸びるかは様子を見ます🤔仮説検証！,73,0,1541,502,https://twitter.com/yosuke_crypto/status/1564446593666908160,73
1564444588135567360,CatLovingWanko,2022-08-30 02:47:10+00:00,マイトップファンってどういうアルゴリズムで順位が決定してるのか気になる。どうも、直近のリプがかなり重視されてそう。いいねはどれぐらい作用してるのかなぁ。,11,0,1296,1273,https://twitter.com/CatLovingWanko/status/1564444588135567360,11
1564443035382849536,TradeFennex,2022-08-30 02:41:00+00:00,ステーブルコインは、特定の資産に価格をペッグ(固定)させた暗号資産です。暗号資産特有のボラティリティを低減して、資産価値の極端な騰落を防ぐ目的で開発されました。一般的に、法定通貨担保型、クリプト担保型、コモディティ担保型、アルゴリズム型の4種類に分けられます。#コトノカアカデミー https://t.co/t9KfRHjGrV,12,3,1190,2258,https://twitter.com/TradeFennex/status/1564443035382849536,15
1564440285060513798,koho_konohoken,2022-08-30 02:30:04+00:00,Notion&amp;”save to Notion”でリスト作りました🙌Twitterのアルゴリズム変わって、交流したい人と交流しづらくなった🥲タイムラインに頼らず自分でアカウト見に行けばいい！と思い作ってみたら、自分でカテゴリやジャンル分けもできるしめっちゃ便利😍 Twitterのリストもいいけど、Notionも意外とアリ😆,29,1,1484,1842,https://twitter.com/koho_konohoken/status/1564440285060513798,30
1564426221688983553,5hosokawa,2022-08-30 01:34:11+00:00,Twitterアルゴリズムくん、鳥の死体持ってきてくれる猫みたいなもん,18,8,677,1200,https://twitter.com/5hosokawa/status/1564426221688983553,26
1564424121575804928,toshhh__,2022-08-30 01:25:50+00:00,TLの表示を新着順にしても、今のアルゴリズムだと投稿は間引きされるのね。関係性とも言い切れない「相互リアクション」が全ての基準なら、いよいよフォロワーとは何ぞや？ってなる。#SNS運用TIPS,16,0,1335,1104,https://twitter.com/toshhh__/status/1564424121575804928,16
1564419792429535232,nkyaaah,2022-08-30 01:08:38+00:00,直撃！【直撃】木村新司が「アルゴリズム」で描く、次の10年 https://t.co/1sF2KP3Nog,11,2,222,417,https://twitter.com/nkyaaah/status/1564419792429535232,13
1564579257690382336,Cuznoha,2022-08-30 11:42:18+00:00,困っているのは「AI翻訳の手直しやってw　手直しだからお安くねw」という人が増えたこと。平たく言えば「他人が書いた、バグだらけのわけわからんソースコードを解読して虫潰してキレイめにしてね」ということなので、「面倒臭え。私のクオリチーの成果物がほしいなら、直で私にご依頼ください」です。,13,2,1440,242,https://twitter.com/Cuznoha/status/1564579257690382336,15
1564566095645646848,sakata_web,2022-08-30 10:50:00+00:00,SP時に少し上下にも移動するスライダー面白い動きだなと思って少しソースコードを見てみたらswiperでした。swiperってこういう表現もできるのですね！スライダー実装は毎回結構悩むのですが、1つライブラリを決めてカスタマイズをガチった方が良いのだろうか？🤔https://t.co/qZIQXCI73S https://t.co/qG2WF6ysrW,40,0,819,176,https://twitter.com/sakata_web/status/1564566095645646848,40
1564538485469749251,Mizuiro__sakura,2022-08-30 09:00:17+00:00,反応拡散系Gray-Scottモデル(2種類の化学物質が反応しながら拡散していく様子)のシミュレーションのソースコードです。#プログラミング#プログラミング初学者と繋がりたい #駆け出しエンジニアと繋がりたい #python#反応拡散系 https://t.co/EJ3OaKoYQz,20,2,126,161,https://twitter.com/Mizuiro__sakura/status/1564538485469749251,22
1564538342657921024,Mizuiro__sakura,2022-08-30 08:59:43+00:00,反応拡散系Gray-Scottモデル(2種類の化学物質が反応しながら拡散していく様子)のシミュレーションです。ソースコードは次のスライドを見て下さい。#プログラミング#プログラミング初学者と繋がりたい #駆け出しエンジニアと繋がりたい #python#反応拡散系 https://t.co/gkeGSfIt4J,21,1,126,161,https://twitter.com/Mizuiro__sakura/status/1564538342657921024,22
1564471782899257344,ikwzm,2022-08-30 04:35:14+00:00,Xサーバーのソースコードみてるんだけど、、、なんか老舗の秘伝のタレ感満載で、ま～よ～わからんわ。,16,4,1610,497,https://twitter.com/ikwzm/status/1564471782899257344,20
1564464818421223424,hiroyukicom4,2022-08-30 04:07:33+00:00,【オープンソース】 - Google ニュースGitHub、Ruby on Rails向けのデータベースアダプタをオープンソースとして公開 - CodeZine（コードジン） #ニュース #オープンソース #IT  #プログラミング #ITエンジニア #webデザインhttps://t.co/Gi6vAelIkX,11,1,168,279,https://twitter.com/hiroyukicom4/status/1564464818421223424,12
1564457602414628864,mntneko_,2022-08-30 03:38:53+00:00,ソースコードも絵も全部AIにパクられるようになったのでインターネットに一般公開することに非常に慎重になった世界線が見たい,11,2,1022,837,https://twitter.com/mntneko_/status/1564457602414628864,13
1564457084439396352,ysinc0419,2022-08-30 03:36:49+00:00,【PCモニタって2台あった方がいい？】結論：画面が見づらいならあった方がいい少なくとも私はソースコードを書く画面とWeb画面やアプリの画面を確認する用に分けてないと作業しづらいのでデュアルディスプレイにしてます…笑#駆け出しエンジニアと繋がりたい#web制作#HTML#CSS#webデザイン,17,0,1133,968,https://twitter.com/ysinc0419/status/1564457084439396352,17
1564447822476640256,kakedashiman1,2022-08-30 03:00:01+00:00,複数人で開発をする場合、GitHubが便利です。GitHubは、ソースコードのバージョンを管理(更新履歴や変更差分など)してくれるWebサービスです。メールアドレスさえあれば、簡単にGitHubを使うことができます。#駆け出しエンジニアと繋がりたい,19,0,1421,271,https://twitter.com/kakedashiman1/status/1564447822476640256,19
1564430615650639872,Garden__Tree,2022-08-30 01:51:39+00:00,mimicがなんで燃えたのかについての意見おそらく開発者の方はアレを「GitHub Copilot」のノリで作ったんだと思うエンジニアには、自分の創作物（ソースコード）をオープンソースにして公開する文化があって、何ならそれを丸々コピーして新しいプログラムを作ったりするそこが絵師さんとの違い,61,33,365,1237,https://twitter.com/Garden__Tree/status/1564430615650639872,94
1564425080259907584,izreit,2022-08-30 01:29:39+00:00,ソースコードと絵は属人性が全然違うでしょ……。例えば、絵柄からはっきり想起されるイラストレータの絵が、政治・宗教やヘイトを撒き散らすSNSアカウントのアイコンとして定着した時のダメージは、同じアカウントに自作のWebサービスが愛用される時のそれとは、恐らく比較にならない。,11,10,126,57,https://twitter.com/izreit/status/1564425080259907584,21
1564417807210536960,verysmile244,2022-08-30 01:00:45+00:00,うちは今日はロングもショートもなしでした😲自分でソースコードを確認してもよくわかりませんでした笑短期間で色々作ってきたから覚えてないのと素人上がりだからわかりにくい記述してるんですよねきっと。こういうところも学んでいかなきゃだなぁ。,21,0,1361,286,https://twitter.com/verysmile244/status/1564417807210536960,21
1564246837439377409,nikumakare,2022-08-29 13:41:23+00:00,9月のにくまきGPの告知します！9/1 22:00からWeb謎「SHARE」を公開します。謎を解き、最も早くクリア登録フォームに回答できた方が優勝となります。ソースコードの閲覧等のズルは禁止、文句は可です！#SHARE謎 https://t.co/9yfUFC10AG,15,3,602,669,https://twitter.com/nikumakare/status/1564246837439377409,18
1564237736638308352,tomo555777,2022-08-29 13:05:13+00:00,■模写コーティング■参考サイト：Codestep8ッ目のサイトを模写中。今回はなんか時間がかった。pc画面は出来ないところがあって中途半端に終わった。デモのソースコードでわかるでしょう。次、スマホ画面やる。#プログラミング初心者と繋がりたい #駆け出しエンジニアと繋がりたい#Web制作,18,0,651,781,https://twitter.com/tomo555777/status/1564237736638308352,18
1564232543905259521,ojousa_ma_yo,2022-08-29 12:44:35+00:00,死後に自分の情報資産を無料で公開できるサービスを作りたい。たとえばゲーム開発で、自分が生きている間は自分が開発するけど、死んだあと誰かに引き継いで貰えるようにソースコード等を無料公開できるシステムです。そういうサービスありますかね？無ければいつか作りたい（覚書）,16,0,1066,370,https://twitter.com/ojousa_ma_yo/status/1564232543905259521,16
1564211651548565504,nwoyoshi,2022-08-29 11:21:34+00:00,ちょっと技術的に解説しておくと、基本的にAIで画像を生成する際にシードが振られて同じパターンの物は作れないようになっているんだよねシードを固定することは可能だけど、今の所ソースコードをいじる以外に方法が無いからAIが作家の特徴を掴んで同じようなタッチで生成する確率は低いってロジック,11,4,271,439,https://twitter.com/nwoyoshi/status/1564211651548565504,15
1564077766718652416,timeiskane,2022-08-29 02:29:33+00:00,好きじゃないのに、仕方なくソースコード書いてるっていう職業プログラマさん。イヤイヤものづくりしてると、誰かが不幸になる気がするので、意識だけでも変えていただけたら嬉しいです。#好きこそものの上手なれ#IT業界を目指す人へ#駆け出しエンジニアと繋がりたい,13,0,383,601,https://twitter.com/timeiskane/status/1564077766718652416,13
1564558534549078017,kinunori,2022-08-30 10:19:57+00:00,JAWS DAYS 2022 の バーチャルサテライト会場 ＠ oVice で準備ミーティング中！デザイン中の背景をチラ見せ#jawsdays2022 #jawsdays #jawsug #aws https://t.co/a6pcMzFPQI,14,0,1351,905,https://twitter.com/kinunori/status/1564558534549078017,14
1564556768990347264,aws_TakS07,2022-08-30 10:12:56+00:00,フォロワー1000人と繋がることができました✨プログラミングの勉強を始めた1年半前はフォロワー数9人だったのに…。ゆっくりですが多くの人と繋がることができました。今後ともよろしくお願いします🙇‍♂️,22,0,1004,300,https://twitter.com/aws_TakS07/status/1564556768990347264,22
1564538374677217281,masaosaan,2022-08-30 08:59:50+00:00,#AWSDevLiveShow 次回はアジャイルよもやま話です!!https://t.co/VX6o831ENd,16,5,943,483,https://twitter.com/masaosaan/status/1564538374677217281,21
1564518397391826944,AWS_Inc_recruit,2022-08-30 07:40:27+00:00,弊社も盛り上げます🥳✨#富山Twitter会🏔#北陸Twitter会 https://t.co/YZrSuTr3zI,14,1,1872,1807,https://twitter.com/AWS_Inc_recruit/status/1564518397391826944,15
1564493984080478209,toro6221,2022-08-30 06:03:27+00:00,@aws_official 歓声や音楽は狭いコンクリートのプールの中を高速で乱反射するので音の世界に生きるイルカにとっては、ただのストレスにしかならない。水族館はただの娯楽施設。イルカに聞こえる周波数100Hz〜150kHz人間は20Hz〜20kHz音の伝わる速さ空気中=秒速340m水中=秒速1500m https://t.co/NZYNcSj4fG,13,6,851,488,https://twitter.com/toro6221/status/1564493984080478209,19
1564474054983045122,Ny_flee,2022-08-30 04:44:15+00:00,帝京大学理工学部 情報科学科 通信教育課程 入学します。情報系の基礎を固めてきます。ついでに、工学の学士も取得してきます。なぜなら、高卒というだけで、書類すら受け取ってもらえない所が多いからです。CCNA LPIC AWS を持っていて、経験あったとしてもです。,80,2,410,653,https://twitter.com/Ny_flee/status/1564474054983045122,82
1564456407810048000,msy78,2022-08-30 03:34:08+00:00,拙書の一つである「AWSコンテナ設計・構築[本格]入門 Kindle版」が期間限定で半額みたいなので、まだお持ちでない方はぜひ📗https://t.co/C18xUAm64b,18,2,1833,253,https://twitter.com/msy78/status/1564456407810048000,20
1564454089437892609,eichan0711,2022-08-30 03:24:55+00:00,先週面談をした、AWS設計構築案件の内定を頂きました！10月から就業開始しますが、現場に入ってから困らないように、AWS学習を継続します。,80,2,201,70,https://twitter.com/eichan0711/status/1564454089437892609,82
1564447824569409536,moveitAcronet,2022-08-30 03:00:02+00:00,VMwareがクラウド設定チェックツールを無料提供VMwareはPaaSなどの設定ミスをチェックできるツール「CloudHealth Secure State」の無料版を提供すると発表AWS、Azure、GCPなどの設定ミスを検知して通知する#駆け出しエンジニアと繋がりたい#エンジニアと繋がりたいhttps://t.co/eWHIct7gks,18,1,649,627,https://twitter.com/moveitAcronet/status/1564447824569409536,19
1564444014593851393,ke_ni_,2022-08-30 02:44:53+00:00,このAWSの無料トレーニングの動画すごくよくない？ #AWS 無料の AWSトレーニング AWS Technical Essentials 日本語実写版 https://t.co/dnSgq7gWDR @YouTubeより,13,0,773,753,https://twitter.com/ke_ni_/status/1564444014593851393,13
1564443796074819584,Noel_vegan_,2022-08-30 02:44:01+00:00,@aws_official イルカ🐬は視力はいいのでしょうか？こんな視界も悪く目がチカチカしそうな状態のなかでアクロバットなことをやらせるのは、怪我やストレスによる病気に繋がったりはしないでしょうか？頼りになるエコロケーションも充分に働かせているでしょうか…考えてみてください🤷🏻‍♀️,10,4,325,311,https://twitter.com/Noel_vegan_/status/1564443796074819584,14
1564443037413015552,NoticeperiodCom,2022-08-30 02:41:00+00:00,8/30【Instagram更新】随時最新の案件情報を掲載しています💁‍♀️是非ご覧ください！https://t.co/A0olwCNAFx#Java #Python #SQL #AWS #リモート #在宅ワーク #転職 #エンジニア転職 #駆け出しエンジニアと繋がりたい #企業公式相互フォロー #企業公式夏のフォロー祭り#ses #フリーランス,40,3,143,82,https://twitter.com/NoticeperiodCom/status/1564443037413015552,43
1564442657295740929,NGY_it_anken,2022-08-30 02:39:30+00:00,8/30【Instagram更新】随時最新の案件情報を掲載しています💁‍♀️是非ご覧ください！https://t.co/40DmULeEeQ#Java #Python #SQL #AWS #リモート #在宅ワーク #転職 #エンジニア転職 #駆け出しエンジニアと繋がりたい #企業公式相互フォロー #企業公式夏のフォロー祭り#ses #フリーランス,20,2,656,672,https://twitter.com/NGY_it_anken/status/1564442657295740929,22
1564440227208626179,tsunasaamon,2022-08-30 02:29:50+00:00,AWS SAP合格した！！#駆け出しエンジニア https://t.co/Kaw47Yg2py,52,1,358,347,https://twitter.com/tsunasaamon/status/1564440227208626179,53
1564435067773939712,hanatomura,2022-08-30 02:09:20+00:00,AWSメリット・従量課金制でコスト最適化・今必要なものをチョイスする自由度の高いカスタマイズ・各種サービスが豊富で、色んな意味で拡張性が高いデメリット・定額制と比べて使い方によって割高・自由度とサービスが豊富な分、それを扱うノウハウは要求されるこんなとこなのかな？,10,0,142,141,https://twitter.com/hanatomura/status/1564435067773939712,10
1564428093183258625,emiko_iret,2022-08-30 01:41:37+00:00,先日お話しした23卒の内定者懇親会の様子です💕皆可愛かった〜🥰フレッシュさが眩しかった🌸🌸🌸#プログラミング#駆け出しエンジニアと繋がりたい#エンジニア #AWS#新卒 #21卒 #22卒 #23卒 #24卒 https://t.co/awQw6Mgryc,14,2,139,171,https://twitter.com/emiko_iret/status/1564428093183258625,16
1564421164449304577,gatlingmiyuki,2022-08-30 01:14:05+00:00,AWSの取得している公的認証を調べてたら、なんと４８個も取得していて本当尊敬、、他国独自のものもあるため、知らないのも結構ある、、https://t.co/QolOSmoaWm,11,2,1924,1376,https://twitter.com/gatlingmiyuki/status/1564421164449304577,13
1564414965179895810,numaguchi,2022-08-30 00:49:27+00:00,"公開遅くなり申し訳ございません！よろしくお願いいたします！ #jawsug #AWSUserGroups #jawsdays今週のAWSユーザーグループ勉強会 8/29-9/4｜NUMAGUCHI, Shigeru @numaguchi #note https://t.co/e86UbhRZmJ",12,7,1590,1440,https://twitter.com/numaguchi/status/1564414965179895810,19
1564414681665908736,briete_ns,2022-08-30 00:48:20+00:00,SAP on AWS受けてくる,11,0,206,194,https://twitter.com/briete_ns/status/1564414681665908736,11
1564410572653101056,AWS_Inc_recruit,2022-08-30 00:32:00+00:00,おはようございます！現在の富山はくもり☁️台風が日本に近づいているみたいですね🌀どっちの方向に行くのが予想が難しいようです。昨日みたいな晴れが続いてほしいなあ🥺今日もがんばりましょう🙌#富山Twitter会🏔 #企業公式が毎朝地元の天気を言い合う#企業公式夏のフォロー祭り,52,0,1872,1807,https://twitter.com/AWS_Inc_recruit/status/1564410572653101056,52
1564405753741721600,fu3ak1,2022-08-30 00:12:51+00:00,書きました。便利〜。日本語対応したらこれしか使わないかもSlack経由で簡単にAWSへ問い合わせ！AWS Support App in Slackを使用する - NRIネットコムBlog https://t.co/gotw2hrhsq @fu3ak1から,40,5,926,204,https://twitter.com/fu3ak1/status/1564405753741721600,45
1564405542168039425,hanatomura,2022-08-30 00:12:01+00:00,「AWSのしくみと技術がこれ1冊でしっかりわかる教科書を読む」ざっくりだけど、読み終わり。新しい概念も多くて、仕組みを理解するにはせめてもう１周読む＆実際AWSに触れる必要がありそうだけど、AWSを選択するメリットと、その基準はなんとなくイメージできてきたな。#RUNTEQ,11,0,142,141,https://twitter.com/hanatomura/status/1564405542168039425,11
1564391221669220352,yuru_minimalist,2022-08-29 23:15:06+00:00,"◾︎朝カフェAWS SAP koiwa問題集 #12,13/全#69少しずつ進んでます🎶有休消化のため、来月10月1日～16日までお休みになったᐠ(  ᐢ ᵕ ᐢ )ᐟこれは今回のUdemyセールで爆買いし、溜め込んでくしかないかな……✨なにしよ〜たーのーしーみーー🤩!!",14,0,1379,110,https://twitter.com/yuru_minimalist/status/1564391221669220352,14
1564390334272249856,mojogeek666,2022-08-29 23:11:35+00:00,AWS SAAちゃんと合格してた。しかも890点という中々の高得点。何をどう間違えたら受かるんだ、という感じでびっくりしている。運が良かったんだろうな。,14,0,431,445,https://twitter.com/mojogeek666/status/1564390334272249856,14
1564379156724731904,teku8kfEkJLBCqh,2022-08-29 22:27:10+00:00,おはようございます☀出社まで1時間半ほど時間確保できたのでAWSの学習始めていきます！#駆け出しエンジニアと繋がりたい#web制作,15,2,56,55,https://twitter.com/teku8kfEkJLBCqh/status/1564379156724731904,17
1564281461473423361,hashedrock,2022-08-29 15:58:58+00:00,pixiv一位を専有する謎の神絵師。その正体はAIであった。人間は失われた栄光を奪還すべく、AWSのデータセンターにマサカリを持って侵入を図るのだった,11,1,1989,783,https://twitter.com/hashedrock/status/1564281461473423361,12
1564266930940157953,site_webmaster,2022-08-29 15:01:13+00:00,@site_webmaster【試験区分】AWS認定資格 CLF（クラウドプラクティショナー）【第59問】 事実上無制限のサイズを使えるストレージサービス正解は「エ」です。解説はこちら↓https://t.co/0z4rXuqox9#駆け出しエンジニアと繋がりたい#プログラミング初心者#インフラエンジニア,12,0,75,66,https://twitter.com/site_webmaster/status/1564266930940157953,12
1564586296655642626,handlename20,2022-08-30 12:10:16+00:00,本日の成果。冥成長、ガリユ＋1。のんびりペースで進行中。支援グラスタやGitがある程度集まってきたので、グラスタ整理を引き続きやっていこうかと思います。 https://t.co/NyptWIKtYv,11,0,743,875,https://twitter.com/handlename20/status/1564586296655642626,11
1564476804882378753,RTX5090,2022-08-30 04:55:11+00:00,#駆け出しエンジニアと繋がりたい 「Git 学習レッスン I」レッスンを修了しました！ https://t.co/0IZ02x8uDn #Progate,20,0,269,10,https://twitter.com/RTX5090/status/1564476804882378753,20
1564443838667956224,KT_04261997,2022-08-30 02:44:11+00:00,"VSCodeでコンフリクトが起きた時のUIが変更されているようなので、もし前のUIに戻したい場合参考にしてください。①VSCodeの設定から【settings.json】を開く②【""git.mergeEditor"": false】を追記する#VSCode#駆け出しエンジニアと繋がりたい #git#コンフリクトhttps://t.co/zqd8Apn4Sq",13,1,111,29,https://twitter.com/KT_04261997/status/1564443838667956224,14
1564422965479239681,koic,2022-08-30 01:21:15+00:00,コードのセルフレビューには3つのタイミングがある。1. git push 前の git log -p2. PR を開く前のブラウザでの差分3. PR を開いた直後のブラウザでの差分というような話を昨日 1on1 で話していた。特に 1 は開発中何度も行う。,16,0,1995,260,https://twitter.com/koic/status/1564422965479239681,16
1564402351619784705,3RhNnCTXiYtAlli,2022-08-29 23:59:20+00:00,私は基礎だと思ってたんだが、意外とみんな知らないGitコマンドgit stash下書き保存の様なコマンド。まじで便利。間違えると大変な事になるが、git stash popで、どのブランチにも下書き反映が可能。皆んなどうやってpullした時のエラー解消してるの？#駆け出しエンジニアと繋がりたい,22,0,42,50,https://twitter.com/3RhNnCTXiYtAlli/status/1564402351619784705,22
1564381958263939072,yukiMUM22,2022-08-29 22:38:18+00:00,今日は3時👶🏻🍼のあと、目が冴えて朝活☀️結局眠気が襲い6時ごろ寝ました💤コーダー求人でちょこちょこ見る、必須条件のGit。苦手意識つぶすため #デイトラ で勉強そういえば昨日、家の外壁に小さいムカデ。窓から入りそうな位置😱虫苦手だけど殺虫剤でやっつけました😭子供のためだと体が動く❗️,42,0,1081,683,https://twitter.com/yukiMUM22/status/1564381958263939072,42
1564358396870291456,mota_2021web,2022-08-29 21:04:40+00:00,ここ数日家庭内の手足口病連鎖で活動が止まってました😵‍💫今日からまたしっかりやっていきます‼️♾ブログの記事作成♾コーディング♾Git学習勝手に今日のやること宣言して頑張っていきます💪🏻ヤル気だけは復活✨#デイトラ #web制作,16,1,135,69,https://twitter.com/mota_2021web/status/1564358396870291456,17
1564272497708912642,okaz_hub,2022-08-29 15:23:20+00:00,Day21(today:2h30 total:42h30)□今日やったこと・Rails テスト・command Lineに触れてみよう□明日の目標・command Line テスト・GIt、JavaScriptに触れてみようそろそろ面談の日程調整しないとな・・・。#RUNTEQ #1000時間チャレンジ,17,0,95,82,https://twitter.com/okaz_hub/status/1564272497708912642,17
1564255685218816004,DuhHz6,2022-08-29 14:16:32+00:00,"Day 10~13 &gt;&gt; 6h, Total 35.5h□頑張り・Progate　　Rails 道場Ⅳ　　CommandLine　　Git　　JavaScript Ⅰ〜Ⅲ・プログラミング入門テスト×3□明日の目標・Progate JavaScript　2hひょえ、一気にスキップしてしまった😇　頑張ろう私",20,0,92,92,https://twitter.com/DuhHz6/status/1564255685218816004,20
1564217737341153280,Riyu_IT,2022-08-29 11:45:44+00:00,8/29Gitの勉強初めていきますってことで購入and視聴。残業のせいであんま時間取れてない明日からもっと頑張りまっしょい！！#りゆの積み上げ#駆け出しエンジニアと繋がりたい https://t.co/yaYPU76aHk,13,0,16,12,https://twitter.com/Riyu_IT/status/1564217737341153280,13
1564216617487122432,git_mifu,2022-08-29 11:41:18+00:00,幼馴染とラーメン食ってサウナあーあだから言ったのに　キマっちゃった https://t.co/2pkOyVf3xK,13,1,220,501,https://twitter.com/git_mifu/status/1564216617487122432,14
1564092091860283392,git_mifu,2022-08-29 03:26:28+00:00,音楽自習、旋律創作でちょっと離れたとこにいるギャル達が「これ9thの方可愛くない」とかテンションノートの話しててバカおもろい,11,1,220,501,https://twitter.com/git_mifu/status/1564092091860283392,12
1564071547572080640,RyoMa_0923,2022-08-29 02:04:50+00:00,&gt; 同僚が全員gitを使えるってだけで贅沢な職場まじでこれはそうなのよね https://t.co/CFA221nQPe,17,0,1838,1032,https://twitter.com/RyoMa_0923/status/1564071547572080640,17
1564020251909832709,yuka80709,2022-08-28 22:41:00+00:00,🌟2022.08.28💡やったこと《WordPress》ハンバーガーサイト計: 3時間30分✍️感想headerのテンプレート化を試みるがcssがあたらなくて詰まる。sを忘れてるという凡ミスに気付けなかった。今までと全く違うのでほんと初めが大変。そしてまたgitがおかしいので、やり直しかな、,13,0,94,82,https://twitter.com/yuka80709/status/1564020251909832709,13
1563987983484985345,lo48576,2022-08-28 20:32:47+00:00,関係ないというか、全然プログラミングと関係ないことも同じくらい git に関係あるというべきか,21,4,590,131,https://twitter.com/lo48576/status/1563987983484985345,25
1563987709722763264,lo48576,2022-08-28 20:31:42+00:00,git はプログラミングに関係ない、マジでそれなんだよな,38,15,590,131,https://twitter.com/lo48576/status/1563987709722763264,53
1563937410232135680,iotassss,2022-08-28 17:11:49+00:00,45日目のご報告今日は初めてGitでpushしました！！😆😆😆今までなんとなくヤヤコシそう、と思って避けてきたGitですが、実際に使ってみると、そうでもなさそうです！やっぱり実際に手を動かして使ってみるのは大事ですねぇ。（進捗: 12-2）#独学エンジニア#駆け出しエンジニアと繋がりたい,28,0,197,191,https://twitter.com/iotassss/status/1563937410232135680,28
1563897548850757633,vTz4E20oLLV1Mp7,2022-08-28 14:33:26+00:00,今日の勉強時間　5時間勉強内容ポートフォリオの作成git pushでエラーが出たため、調査#駆け出しエンジニアと繋がりたい,14,1,71,41,https://twitter.com/vTz4E20oLLV1Mp7/status/1563897548850757633,15
1563887480193294336,hamuhmau_Humi,2022-08-28 13:53:25+00:00,弊社「若い人材が定着しない」って悩んでいたけど、VSCodeも知らない。Gitも知らない。コードは階層化されていなくて、ぐちゃぐちゃ。ARMマイコンも使いたくない。それじゃあ、定着しない…。「保険に入らないで競技向け自転車で80Km/h出して。環八で。」って言われているようなモノだよ…。,11,1,488,483,https://twitter.com/hamuhmau_Humi/status/1563887480193294336,12
1563871081978482688,robotakao,2022-08-28 12:48:15+00:00,一応、ガーバーデータはGithubに置いといたhttps://t.co/XQAVhTHGHW https://t.co/ZL5DUjpiNf,20,2,1801,948,https://twitter.com/robotakao/status/1563871081978482688,22
1563854494210920449,Tae86817394Tae,2022-08-28 11:42:21+00:00,Git hubでソースコードが全部消えちゃった。あーあ超ショックで寝込みそう。#駆け出しエンジニアと繋がりたい#github,13,0,125,190,https://twitter.com/Tae86817394Tae/status/1563854494210920449,13
1563838198899306496,anz_4th,2022-08-28 10:37:35+00:00,自分でグラスタお料理できるようになってもgitがなぜか誰かに取られてるのか消え去るのか材料なのか…😦💎✨🔨💸💸💸　🐈‍⬛ https://t.co/amvCaXzhPa,15,0,142,154,https://twitter.com/anz_4th/status/1563838198899306496,15
1563830211984359425,okifuku1000,2022-08-28 10:05:51+00:00,駆け出しエンジニアが初めてインターンに参加する前に自分が勉強してるプログラミング言語以外にGitやGithubをちょっと触っておくとすげー実務に入りやすくなるからおすすめ！基本的な部分だけでいいから見ておくと👍#駆け出しエンジニア#プログラミング初心者,12,0,37,4,https://twitter.com/okifuku1000/status/1563830211984359425,12
1563806121374072833,hisayuki_ik,2022-08-28 08:30:08+00:00,とりあえず、drf-spectacularは便利ですね。別でAPI仕様書を書かなくても、APIのテストなんかを簡易的に実施できるのはとてもいいと思う。ソースコードに埋め込みでGitによる差分が比較出来ますし、DjangoRestFramework使ってる人は是非使ってほしいです。,13,0,959,1018,https://twitter.com/hisayuki_ik/status/1563806121374072833,13
1563710980374528001,ysk91_engineer,2022-08-28 02:12:04+00:00,gitの設定しようと思ったら初手で詰んだ😂😂😂1時間って言ってんのに😂😂😂#駆け出しエンジニアと繋がりたい #プログラミング初心者と繋がりたい https://t.co/nz0FWmvJIx,11,0,30,23,https://twitter.com/ysk91_engineer/status/1563710980374528001,11
1563466419320541184,TechUni1026,2022-08-27 10:00:16+00:00,Tech.Uni 勉強会昨夜「Gitこと初め」＆「KMMとAndroid」の勉強会が開催されました🔥前者を担当したのは、1回生ながら初LTを見事完遂した“中平陽菜”さん🎉後者を担当したのは、実力を兼ね備えたAndroidエンジニアの“八木利生太朗”さん🎉#TechUni#大学生#エンジニア#プログラミング https://t.co/um2BPHMlnJ,10,0,541,31,https://twitter.com/TechUni1026/status/1563466419320541184,10
1564578058925133825,comi_design,2022-08-30 11:37:32+00:00,開業前フリーランスあるある:不用品売りに行くときの職業何に丸するか迷うほぼフリーターだと思って生きてる…#フリーランス大会議,10,0,137,212,https://twitter.com/comi_design/status/1564578058925133825,10
1564577211839311872,osakameri,2022-08-30 11:34:10+00:00,フリーランスとミニマリストの相性いいなと思うのですよ経験が浅い状態で6月からライターとして活動をはじめたのですが、ミニマリスト思考のおかげでひと月に必要なお金が少なく済んでるからフリーで生活できてるとこある🫠 #フリーランス大会議,10,0,13,9,https://twitter.com/osakameri/status/1564577211839311872,10
1564576681847037954,comi_design,2022-08-30 11:32:04+00:00,退職してフリーランスになってまず固定費を下げました…それまで学生時代から毎月家計簿つけたからそれを元に計算して家賃とかも考えて引っ越ししたけど、それ通りに生活できててヨッシャって感じ…！#フリーランス大会議,11,0,137,212,https://twitter.com/comi_design/status/1564576681847037954,11
1564572662143127552,yutaro_gr,2022-08-30 11:16:05+00:00,【みんなどうやって「案件獲得」してるの】@kazzikill じきるうさん主催で、@milkprincess17 ゆぴさん、高橋まりなさん、KOMさんをゲストに招き、フリーランスの案件獲得方法について、熱い議論が展開されてました！#フリーランス大会議 https://t.co/wFjUwtLoL6,28,4,155,30,https://twitter.com/yutaro_gr/status/1564572662143127552,32
1564570654527041537,mymai_free,2022-08-30 11:08:07+00:00,@minogori 「アフィリエイトでフリーランスを目指す」を目標に、爆走中のマイマイと申します😊会社に縛られず、ストレスフリーに生きたい！と思い立ち、ネットビジネスに身を投じました。今は、商売の要、集客をツイブラ×Twitterで勉強中。わからないことばかりなので、ご指導よろしくお願いいたします😄 https://t.co/daxKDNwXu7,44,8,348,490,https://twitter.com/mymai_free/status/1564570654527041537,52
1564570019119648769,doula_shiyya,2022-08-30 11:05:35+00:00,@minogori @mithrilweb しーやです☺3児のママでフリーランスで仕事してて、うつ持ちですけど、それでもブログでお家で稼げる！を実況するメルマガ『しーやメソッド』配信中です📩これから稼ぎたい方必見👀！プロフ＆固ツイ見てね✨フォローしてくれた方、ほぼもれなくフォロバします♥気軽によろしくです☺,41,2,623,2080,https://twitter.com/doula_shiyya/status/1564570019119648769,43
1564569674918281217,Deep_Blue_taki,2022-08-30 11:04:13+00:00,フリーランスのお仕事もあと少しで終わり😌いろんな土地に行って、いろんな出会いがあったな…☺️“一期一会”って言葉を大切にしたい。たくさんのことを学ばさせてもらい、薬剤師として、人として少しは成長出来たかな？楽しい一夏の思い出に…☺️🌻🎐全ての出会いに感謝。仕事に全力だぜ！🐶🔥,13,0,152,179,https://twitter.com/Deep_Blue_taki/status/1564569674918281217,13
1564569594702209024,techcamp_study,2022-08-30 11:03:54+00:00,【プログラミングで収入を得るロードマップ】①副業フロントのスキルを中心に学習する※最初は単価より実績作りを優先②転職ゼロからサービスが作れるスキルを幅広く学ぶ③フリーランス一度企業で経験を積んでから独立を目指す#プログラミング初心者 #駆け出しエンジニアと繋がりたい https://t.co/c0i766drXK,14,0,143,1,https://twitter.com/techcamp_study/status/1564569594702209024,14
1564569437851660288,shuntech88,2022-08-30 11:03:16+00:00,案件獲得に共通するポイント・SNS頑張ろう・自分から提案・ポートフォリオ・オフラインを大切に・周りにやりたいこと言う人によって向き不向きがあるとは思いますが、SNSで発信しているフリーランスの方には割と当てはまるのかな〜と思いました！#フリーランス大会議,15,1,322,251,https://twitter.com/shuntech88/status/1564569437851660288,16
1564568977245761537,kazu20220601,2022-08-30 11:01:27+00:00,@minogori カズと申します。フリーランスで宅配のお仕事を請け負いながらスキマ時間を有効に使ってある転売やっています。仲良くしてくださぁーい😊ノウハウコレクターだった私がコツコツながら徐々に台数、売上、利益を出し始めてる転売ノウハウ。とにかく成果をあげたい！そんな方にぜひはじめてほしい。 https://t.co/KsKRwgvocP,57,7,581,447,https://twitter.com/kazu20220601/status/1564568977245761537,64
1564567352523386880,TSURUJAM,2022-08-30 10:54:59+00:00,なんかもう凄すぎて、、、！！！ホテル、飲み会、サウナ、SNSだけじゃなくていろんなところに仕事ってあるんだなあ。フリーランスの可能性無限大じゃん！！！😆#フリーランス大会議,18,0,59,90,https://twitter.com/TSURUJAM/status/1564567352523386880,18
1564562778622271488,chuji69,2022-08-30 10:36:49+00:00,「時間もないし、こんな感じでいいか…」と妥協したくなるけれど、次も自分にチャンスがあるのか？と考えると…寝てる場合じゃねー！となったりするのです。DEATH。#ネコキャット#猫と仕事と品質と#フリーランス#グラフィックデザイン#イラスト#illustration https://t.co/JlFQPGswdO,16,0,370,841,https://twitter.com/chuji69/status/1564562778622271488,16
1564561975241191424,dekiruengineer,2022-08-30 10:33:37+00:00,さっそく明日外資系企業の人事担当者の方とお話しすることになった。年収1000万以上だったらフリーランスやめることを考えてもいいなー。,24,1,1362,896,https://twitter.com/dekiruengineer/status/1564561975241191424,25
1564560248819830785,monono_16,2022-08-30 10:26:46+00:00,仕事に繋がる・繋がらないを考えず、色んなところへ積極的に顔を出すのは大事だなって思う。やっぱりフリーランスで仕事する上でコミュニケーション能力は必須スキル…。 #フリーランス大会議,17,1,1637,1503,https://twitter.com/monono_16/status/1564560248819830785,18
1564558499904114688,shuzaiya,2022-08-30 10:19:49+00:00,編集者から指定された〆切よりも早く原稿を送ることを心がけている。不測の事態が起こっても対応できるというのは表向きの理由。何よりも早く終わらせてラクになりたいのだ。でも、早め早めに原稿に取りかかるから、ちっともラクにならない💦#ライター #フリーランス,11,1,746,656,https://twitter.com/shuzaiya/status/1564558499904114688,12
1564558248858255360,RA0611112222,2022-08-30 10:18:49+00:00,半休取ったけど、結局カフェで仕事してる。カフェだと結構仕事できる！カフェってすごいなぁ。フリーランスは、仕事場所ポンポン変えられるから、そこは憧れます,11,0,850,1081,https://twitter.com/RA0611112222/status/1564558248858255360,11
1564557036167532544,fukumaru_story,2022-08-30 10:14:00+00:00,勉強中、無意識にYouTubeに手を伸ばしてしまう症候群の人いますか？それは僕です(笑)思い切ってYouTubeアプリもブックマークも消してみましたが、めちゃ快適です!!見る頻度がかなり減りました。同じ症状の人はぜひ😁✨#web制作 #webデザイン #副業 #フリーランス #ブログ #プログラミング,17,0,449,375,https://twitter.com/fukumaru_story/status/1564557036167532544,17
1564551615709073408,satorei07,2022-08-30 09:52:27+00:00,応援したい、少しでも力になりたいと心から思えるところの発信ばかりを手伝わせてもらえていて、多幸感🍻フリーランスになった理由のひとつが満たされつつある。,13,0,418,672,https://twitter.com/satorei07/status/1564551615709073408,13
1564550306717106178,wearecreators_1,2022-08-30 09:47:15+00:00,WeAreCreatorsインスタグラムで1番人気のインタビュー投稿更新しました！▶︎独立した方々の駆け出し〇〇時期を発信中https://t.co/r4mZfytPwx#独立 #フリーランス #副業 #駆け出しクリエイター #駆け出しエンジニアと繋がりたい #駆け出しwebデザイナーと繋がりたい #web制作 #プログラミング,13,0,389,186,https://twitter.com/wearecreators_1/status/1564550306717106178,13
1564548392797503488,yumegashira,2022-08-30 09:39:39+00:00,私は激怒しています。「とりあえずチーズをトッピングしとけば、美味しくなるだろう」という、企業の安易な戦略に対して。そして、実際にそれで美味しいと感じてしまう、自らの味覚に対して。＃アホ舌＃Webライター＃ブログ＃フリーランス,21,1,887,842,https://twitter.com/yumegashira/status/1564548392797503488,22
1564547988202000384,naruhave,2022-08-30 09:38:02+00:00,"フリーランスで営業かけているのに仕事が取れない！という人は、まず営業のやり方を学ぶのを辞めてください。早急に取り掛かるべきは『商品の理解』取り扱ってる商品を""買わないなんて勿体ない""ここまで落とし込むからこそ本気で売れるようになる自分が欲しくもない商品は絶対に売れません^ ^",13,0,1364,777,https://twitter.com/naruhave/status/1564547988202000384,13
1564547536009932800,combat_medic_JP,2022-08-30 09:36:15+00:00,なんだかんだ用事済ませこんな時間…メンテナンスになってない🤣食べ込む事には成功‼️来月から更に多忙になりそうなので今日のうちに動きました😅フリーランスもあと1日で終了😅致しませんが通用しない世界にまた舞い戻る…でも公務員ってまじ驚くことばかり。福利厚生がえげつない😅＃たまげた,10,0,699,125,https://twitter.com/combat_medic_JP/status/1564547536009932800,10
1564544288968609793,yutoyolonyc,2022-08-30 09:23:20+00:00,学生さんやフリーランスの方でプログラミング頑張っている方と繋がりたいです！どなたでも大歓迎です！自分と繋がったらすごいメリットがあるかもです。#駆け出しエンジニアと繋がりたい #プログラミング初学者と繋がりたい #Progate #Web制作,11,1,1151,1924,https://twitter.com/yutoyolonyc/status/1564544288968609793,12
1564543847857680384,u5musicxit,2022-08-30 09:21:35+00:00,フリーランスになって3ヶ月ぐらいが経つんだけど再来月からの給料がエグすぎてパニクってるわけわからんはエンジニアたかが3年でわけわからん#駆け出しエンジニアと繋がりたい,12,0,119,76,https://twitter.com/u5musicxit/status/1564543847857680384,12
1564543840303796224,takachanoblog,2022-08-30 09:21:34+00:00,"ブログ更新しました！【ストックフォト1枚2,000円で売れたお話】#副業#ブログ#ブログ書け#フリーランス#ストックフォト#フォトグラファー#ブログ仲間募集中#ブログ仲間と繋がりたいhttps://t.co/LWMlD2nJAy",12,1,535,479,https://twitter.com/takachanoblog/status/1564543840303796224,13
1564539954243698688,NGY_it_anken,2022-08-30 09:06:07+00:00,本日もお疲れ様でした🌷夏の終わりに近づいて、日も短くなってきましたね☺季節の変わり目の体調不良に気を付けて明日も頑張りましょう！#企業公式相互フォロー#企業公式夏のフォロー祭り#企業公式がお疲れ様を言い合う #エンジニア転職#駆け出しエンジニアと繋がりたい#フリーランス#SES,37,0,656,672,https://twitter.com/NGY_it_anken/status/1564539954243698688,37
1564540577600774144,ton09876286,2022-08-30 09:08:36+00:00,IT WEB エンジニア向け人気転職サイト「2022最新　3選」おすすめhttps://t.co/s8lNFovOq6#プログラミング初心者 #エンジニア転職 #駆け出しエンジニアと繋がりたい https://t.co/9T5RtgjZqx,10,0,1519,4939,https://twitter.com/ton09876286/status/1564540577600774144,10
1564540421480452096,ton09876286,2022-08-30 09:07:58+00:00,時流はエンジニアです比較した転職サイトで収入アップおすすめhttps://t.co/2pcJYgYJ2V#プログラミング初心者 #エンジニア転職 #駆け出しエンジニアと繋がりたい https://t.co/E5DLFtszbs,12,0,1519,4939,https://twitter.com/ton09876286/status/1564540421480452096,12
1564523323064602624,GEEKJOB,2022-08-30 08:00:02+00:00,今の時代、転職はプログラマーのキャリアアップの一手段なのだ！どんな実績があると次に繋がりやすいのか🤔駆け出しの頃から参考にしておこう！ITエンジニアの中途採用、高評価な実務経験は？ 採用担当者300名を対象とした調査結果https://t.co/XPTyiwRv1w @codezine #駆け出しエンジニアと繋がりたい,12,0,1014,581,https://twitter.com/GEEKJOB/status/1564523323064602624,12
1564511499175006208,LifeActor_japan,2022-08-30 07:13:03+00:00,💕はたらく あなたへ贈る言葉💕✨根本的な才能とは、自分に何かが出来ると信じることだジョン・レノン#エンジニア #人材派遣 #フリーランス#転職 #Twitter転職 #新社会人#駆け出しエンジニアと繋がりたい,15,0,292,508,https://twitter.com/LifeActor_japan/status/1564511499175006208,15
1564498990330269696,ArdaijArarp,2022-08-30 06:23:20+00:00,元フリーターからITエンジニア転職して頑張ってます！目標は独立して一人でバリバリ稼ぐこと！#プログラマー #駆け出しエンジニアと繋がりたい,33,1,72,0,https://twitter.com/ArdaijArarp/status/1564498990330269696,34
1564494034545958912,akka_it,2022-08-30 06:03:39+00:00,"エンジニア以外の収入もあるから20代で年1,000万のミッション達成エンジニア転職しなかったらこのようなことにはならなかったでしょう謝謝#駆け出しエンジニアと繋がりたい",31,0,172,161,https://twitter.com/akka_it/status/1564494034545958912,31
1564469493740343297,god48_,2022-08-30 04:26:08+00:00,フリーランスになる前に、転職は一度することをおすすめします！SESなどで案件変更してもいいと思いますが、歴1年でも経験があれば給料UPできるし、エンジニアにとって縦の知識も必要だけど、横の方が個人的には大事だと思ってる。#フリーランス#駆け出しエンジニアと繋がりたい#プログラミング,29,2,250,39,https://twitter.com/god48_/status/1564469493740343297,31
1564465516709744640,ton09876286,2022-08-30 04:10:20+00:00,IT WEB エンジニア向け人気転職サイト「2022最新　3選」おすすめhttps://t.co/s8lNFovOq6#プログラミング初心者 #エンジニア転職 #駆け出しエンジニアと繋がりたい https://t.co/nomWp1anUh,19,0,1519,4939,https://twitter.com/ton09876286/status/1564465516709744640,19
1564465350678220800,ton09876286,2022-08-30 04:09:40+00:00,時流はエンジニアです比較した転職サイトで収入アップおすすめhttps://t.co/2pcJYgYJ2V#プログラミング初心者 #エンジニア転職 #駆け出しエンジニアと繋がりたい https://t.co/ATJjUGVGcw,19,0,1519,4939,https://twitter.com/ton09876286/status/1564465350678220800,19
1564452382674747393,gUm77GuM,2022-08-30 03:18:08+00:00,プログラミングスクール付きの転職エージェント利用してITエンジニアになれた元フリーターです自分が使って良かったところやそのほか未経験から出IT業界転職に特化してるエージェントについてﾌﾟﾛﾌで解説してるので参考に#駆け出しエンジニアと繋がりたい,10,0,414,376,https://twitter.com/gUm77GuM/status/1564452382674747393,10
1564448218364125184,hikari0net,2022-08-30 03:01:35+00:00,ITエンジニアへの未経験転職を目指す方へのおすすめエージェントをプロフィールでまとめてます！実際使って今現役です#エンジニア転職 #未経験エンジニア #駆け出しエンジニアと繋がりたい,15,0,900,375,https://twitter.com/hikari0net/status/1564448218364125184,15
1564447964877053952,oplan_inc,2022-08-30 03:00:35+00:00,"面接担当者です。この視点があれば内定はかなり取りやすくなるはずです！""インタビューってどんなイメージ？""https://t.co/x3H737MIst#エンジニア #エンジニアと繋がりたい #プログラミング #プログラミング学習 #ブログ仲間と繋がりたい #就活 #転職 #中途採用 #新卒採用 #第二新卒 #面接対策 https://t.co/x1TMdVoWYq",12,2,261,192,https://twitter.com/oplan_inc/status/1564447964877053952,14
1564447848426393605,mynavi_agent_jp,2022-08-30 03:00:07+00:00,エンジニアあるある「あの言語」――作：るしこ様（ @39baby_com ）漫画家様とのコラボ実施中！ぜひフォローお願いします✨#転職 #漫画が読めるハッシュタグ https://t.co/SSPtiAxMZq,612,90,172,11,https://twitter.com/mynavi_agent_jp/status/1564447848426393605,702
1564440957348487168,ton09876286,2022-08-30 02:32:44+00:00,IT WEB エンジニア向け人気転職サイト「2022最新　3選」おすすめhttps://t.co/s8lNFovOq6#プログラミング初心者 #エンジニア転職 #駆け出しエンジニアと繋がりたい https://t.co/KwfQ1PzbW3,15,0,1519,4939,https://twitter.com/ton09876286/status/1564440957348487168,15
1564440766008610817,ton09876286,2022-08-30 02:31:59+00:00,時流はエンジニアです比較した転職サイトで収入アップおすすめhttps://t.co/2pcJYgYJ2V#プログラミング初心者 #エンジニア転職 #駆け出しエンジニアと繋がりたい https://t.co/FpCOQ4LQry,12,0,1519,4939,https://twitter.com/ton09876286/status/1564440766008610817,12
1564396143181582336,OnlineManabi,2022-08-29 23:34:40+00:00,未経験からエンジニアを目指す人へしっかり転職の計画は策定してますか？🤗行き当たりだとなかなか決まらない😥そんな方は〇〇〇〇〇を利用してみて!!🤗✅私にとって永久顧問のような存在💖#駆け出しエンジニアと繋がりたい #転職 https://t.co/uyG5s8JoVL,12,2,341,1182,https://twitter.com/OnlineManabi/status/1564396143181582336,14
1564395159584124929,ohzoragirl,2022-08-29 23:30:45+00:00,まだ暑いですが、だんだん夏の終わり…😅転職活動を行うにも最適な季節になってきましたね🤗未経験からエンジニアを目指している人はここで転職の計画を策定だ🎉▼私にとって永久顧問的な存在😉☑詳しくは固定ツイから#駆け出しエンジニアと繋がりたい #転職 #おは戦40830ak https://t.co/FlTUcCMeQH,13,2,67,240,https://twitter.com/ohzoragirl/status/1564395159584124929,15
1564393231877820416,ohzoragirl,2022-08-29 23:23:06+00:00,平均年収600万の世界💴エンジニアは一般職よりも高給さらに、副業もしたら…ワクワクが止まらない😁もちろん、確定申告も忘れないように(笑)未経験から目指すなら〇〇〇〇〇がオススメですよ!!🤫✅詳しくは固定ツイから…#駆け出しエンジニアと繋がりたい #転職 #おは戦40830ak https://t.co/FlTUcCMeQH,13,2,67,240,https://twitter.com/ohzoragirl/status/1564393231877820416,15
1564392237995216896,OnlineManabi,2022-08-29 23:19:09+00:00,エンジニアになるだけでも年収アップ。平均年収600万の世界💴さらに、副業も入れたら…夢のある職業だよね🤗もちろん、確定申告も忘れないでね(笑)未経験から目指すならウズキャリがオススメですよ!!🤫✅詳しくは固定ツイから…#駆け出しエンジニアと繋がりたい #転職 #おは戦40830ak https://t.co/uyG5s8JoVL,12,2,341,1182,https://twitter.com/OnlineManabi/status/1564392237995216896,14
1564354301601886209,ton09876286,2022-08-29 20:48:24+00:00,IT WEB エンジニア向け人気転職サイト「2022最新　3選」おすすめhttps://t.co/s8lNFovOq6#プログラミング初心者 #エンジニア転職 #駆け出しエンジニアと繋がりたい https://t.co/DgeZ77d59R,14,0,1519,4939,https://twitter.com/ton09876286/status/1564354301601886209,14
1564354067597471744,ton09876286,2022-08-29 20:47:28+00:00,時流はエンジニアです比較した転職サイトで収入アップおすすめhttps://t.co/2pcJYgYJ2V#プログラミング初心者 #エンジニア転職 #駆け出しエンジニアと繋がりたい https://t.co/rq0cPFuBof,15,0,1519,4939,https://twitter.com/ton09876286/status/1564354067597471744,15
1564297497199013888,yuto_44,2022-08-29 17:02:41+00:00,現在インフラエンジニア(運用保守)の24歳です。自分の目指すキャリアと新たな挑戦にかけて転職することにしました。現時点では以下職種を検討しています🤔・インフラエンジニア（上流工程）・システムエンジニア・プログラマ同志の方がいらっしゃいましたら、是非一緒に頑張りましょう✨,11,1,12,12,https://twitter.com/yuto_44/status/1564297497199013888,12
1564267154727247872,sunwachi_hr,2022-08-29 15:02:07+00:00,エンジニアの中途採用ってほんと難しい転職して3ヶ月だからまだまだこれからかと自分を安心させたいところだけどそういう訳にもいかない…😀,105,0,967,930,https://twitter.com/sunwachi_hr/status/1564267154727247872,105
1564247803450126336,ryuryu0213ww,2022-08-29 13:45:13+00:00,転職してまだ5ヶ月だけど、めちゃくちゃ楽しい😇社内だけでなく、社外で色々な考えや技術・目標を持ったエンジニアの方と交流をするとワクワクできる😇幸せである,18,0,255,305,https://twitter.com/ryuryu0213ww/status/1564247803450126336,18
1564194715863773185,ton09876286,2022-08-29 10:14:16+00:00,時流はエンジニアです比較した転職サイトで収入アップおすすめhttps://t.co/2pcJYhgSh3#プログラミング初心者 #エンジニア転職 #駆け出しエンジニアと繋がりたい https://t.co/uFAkhuMiA0,15,1,1519,4939,https://twitter.com/ton09876286/status/1564194715863773185,16
1564194522451431424,ton09876286,2022-08-29 10:13:30+00:00,IT WEB エンジニア向け人気転職サイト「2022最新　3選」おすすめhttps://t.co/s8lNFovOq6#プログラミング初心者 #エンジニア転職 #駆け出しエンジニアと繋がりたい https://t.co/JQiVZK2bBd,14,1,1519,4939,https://twitter.com/ton09876286/status/1564194522451431424,15
1564186307814998016,hikari0net,2022-08-29 09:40:51+00:00,ITエンジニアに転職したい既卒フリーター、第二新卒におすすめのIT・Web業界特化型のエージェントをプロフィールにまとめてますこの業界資格もいらないのに高収入だしスキルを磨けばフリーでもやっていけてる人がいるから一発逆転できる職でもある#駆け出しエンジニアと繋がりたい,15,0,900,375,https://twitter.com/hikari0net/status/1564186307814998016,15
1564176234246012930,TakabotGo,2022-08-29 09:00:49+00:00,【未経験OK】前職の経験を活かせるエンジニアがIT転職で成功する理由 https://t.co/r0QURAGPkm#駆け出しエンジニアと繋がりたい#プログラミング初心者,13,0,169,122,https://twitter.com/TakabotGo/status/1564176234246012930,13
1564174012565135360,tomisenblog,2022-08-29 08:52:00+00:00,30代でエンジニアに転職するなら、絶対的な強みになるのは前職での経験です例えば、接客業はコミュ力が役に立つし、保険・金融業なら業務知識はシステム開発で生かせます。それまでやってきた仕事は、あなたの圧倒的な強みです#駆け出しエンジニアと繋がりたい,24,0,804,109,https://twitter.com/tomisenblog/status/1564174012565135360,24
1564589808529580032,relativity_Eins,2022-08-30 12:24:13+00:00,資料作りの為調べた、ひなにぃさんのエペ動画で使われていた武器とキャラ雑統計です(誤字キモオタ)パスファ・99は多くて数え切れてないです https://t.co/crxLmoIIlC,12,0,1569,470,https://twitter.com/relativity_Eins/status/1564589808529580032,12
1564572379728478208,issa50s_2022,2022-08-30 11:14:58+00:00,#夜勉部通勤電車勉🚃本日も統計検定3級がんばります😁,17,0,456,506,https://twitter.com/issa50s_2022/status/1564572379728478208,17
1564568707036495872,CBR600F2013,2022-08-30 11:00:22+00:00,元ロックバンドSTAnのkygである占い師のニシー@nsikygさんに、占いの根拠と信憑性と統計学と霊感商法との違いと、一年後の自分について聞いてきたよ🧙スピリチュアル系を信じない人にこそ見て欲しいよ🔯#占う男見て！拡散して！！登録して！！！よろしくお願いします😳https://t.co/VYSurss5EI https://t.co/q7oEZ1d1Ua,11,3,345,238,https://twitter.com/CBR600F2013/status/1564568707036495872,14
1564567595663388672,TomoCodeHQ,2022-08-30 10:55:57+00:00,統計数理研究所による統計学入門の講義はなんと無料公開！👀✅データの可視化と要約✅因果と相関✅推測統計✅2項分布✅正規分布✅仮設検定　などなど、統計のことについてがっつり学べるコンテンツが揃ってるね！😉https://t.co/vu5UnA6Ury https://t.co/TA7BvS6saV,14,2,1372,957,https://twitter.com/TomoCodeHQ/status/1564567595663388672,16
1564559989649223682,eNXUWqxboUXEmaG,2022-08-30 10:25:44+00:00,テレワーク中に検討した結果、社労士24を追加で申し込みました。(これは教材きてから使えるの？)苦手な科目はフォーサイトで深く、主要は項目は社労士24で効率重視でやってみます。スマホ画面ではWEB講義が見辛かったのでiPad(9世代)を購入。試験専用で統計データなどもぶち込んでいきます😡,13,0,95,200,https://twitter.com/eNXUWqxboUXEmaG/status/1564559989649223682,13
1564557396222939137,nununi_b,2022-08-30 10:15:25+00:00,面接授業はこちらを申請。完全に趣味で選びました。１つくらいは当選して欲しい。西武鉄道と沿線文化アラビア語初歩：挨拶までカトリック教会と音楽以下は都合があわず諦めた科目。機会があればまた。エクセルで学ぶ統計解析入門しきたりの民俗学イスラームの教義と社会ラテン語のすすめ,10,0,640,607,https://twitter.com/nununi_b/status/1564557396222939137,10
1564554971454259200,nununi_b,2022-08-30 10:05:47+00:00,ということで、来期履修予定（放送授業）・社会学概論・人間にとって貧困とは何か・入門線型代数・統計学・情報社会のユニバーサルデザイン・映像コンテンツの制作技術,10,0,640,607,https://twitter.com/nununi_b/status/1564554971454259200,10
1564553291769720834,Siawaseearth,2022-08-30 09:59:07+00:00,説明責任は誰にありますか?投票機の完全性が問題民主党の口からクリフ・アーネベック: 「これらの異常、コンピュータ操作の形式によってのみ説明できるこれらの統計的異常が見られます。」,14,3,700,521,https://twitter.com/Siawaseearth/status/1564553291769720834,17
1564551454916247552,4869eiji,2022-08-30 09:51:49+00:00,お疲れ様でした😊保有株＋0.93%指数負けですが、下げたのはすかいらーくなど外食株。鉄鋼株は好調ですね。NT倍率はヨコヨコネオモバではトヨタを買っています。😚9月権利の買いたい株はまだ有りますが、上げてる銘柄も多くて悩ましい🤣週末の雇用統計迄はまたまた様子見となるのでしょうか。,11,0,499,192,https://twitter.com/4869eiji/status/1564551454916247552,11
1564550357837291520,NShimohata,2022-08-30 09:47:27+00:00,@teteatete2021 厚生労働省は、人口動態統計速報のデータ改竄も始めた可能性がありますね。厚生労働省を統計法違反で訴える。また、行政文書開示請求で、人口動態統計の元データを開示請求する必要がありそうですね。,16,5,553,252,https://twitter.com/NShimohata/status/1564550357837291520,21
1564546510649380865,megun_t_1123,2022-08-30 09:32:10+00:00,8/30   화요일🌻午後のグンちゃん♡今日のグンちゃんとうなぎには18時の魔の時間帯なんて存在しないんだぁ❤️‍🔥❤️‍🔥❤️‍🔥統計学📔勉強し直しーw#Beautiful  #チャン・グンソク  Jang Keun Suk Goes on https://t.co/OrrhuBishX,12,17,216,171,https://twitter.com/megun_t_1123/status/1564546510649380865,29
1564545788235378688,pikokaomoji,2022-08-30 09:29:18+00:00,@kabubu72897471 @Q0AYLFbvcvnFMnq @5WkXXQqIFC95i5c @baskekun3 頭悪くない？本当にそれで統計学わかってる？！一応さっき偏差値の話が上がったということは統計学やってるよね？だとすると、根本的な学力に影響してるものはゲームではないのは明確よね？,18,0,54,76,https://twitter.com/pikokaomoji/status/1564545788235378688,18
1564538985992851457,AA4yfwrsEEND6s7,2022-08-30 09:02:16+00:00,人口動態統計の6月速報が出た．自然増減数すごいね！ https://t.co/xlfC0X0PS7,10,4,484,607,https://twitter.com/AA4yfwrsEEND6s7/status/1564538985992851457,14
1564538176558878721,megun_t_1123,2022-08-30 08:59:03+00:00,17時更新❣️▼16位！！次は…いや…もうちょっとがまんかな❤️‍🔥❤️‍🔥❤️‍🔥統計上w#Beautiful  #チャン・グンソク  Jang Keun Suk Goes on https://t.co/fiKPVx8cOo,25,22,216,171,https://twitter.com/megun_t_1123/status/1564538176558878721,47
1564535741975506944,TYOBETAN,2022-08-30 08:49:23+00:00,真っ青に燃えた日だ。壱万円は、ナメてかかるからハイレバ過ぎて、狩られがちなことに気付いた10万で５lotくらいが合ってる雇用統計は、遊ぶ予定。 https://t.co/rE5hbJoE4E,20,0,381,375,https://twitter.com/TYOBETAN/status/1564535741975506944,20
1564534940636614656,inv_yamax,2022-08-30 08:46:12+00:00,米国がダメだったので諦めてましたが日本株は反発してくれたみたいでなんとか助かりました。。週末に今度は雇用統計があるのでまだまだ落ち着かない日々ですね。今日もお疲れ様でした🍵#TradeNote https://t.co/St3HFRuK00,46,0,771,321,https://twitter.com/inv_yamax/status/1564534940636614656,46
1564533768597438464,tatsuuu_bknb,2022-08-30 08:41:32+00:00,staffさんからフォロバされた人の統計とってどうやったらフォロー返してくれるか定量的に考察したい卒研のテーマそれでもいい,10,0,373,374,https://twitter.com/tatsuuu_bknb/status/1564533768597438464,10
1564532573673750528,KINKUMACH,2022-08-30 08:36:47+00:00,#日経225 (買1枚)5枚分決済して、＋20.4万円の利益確定です🤗下がれば買い増ししていきますよ～。ただ、おそらく上昇は長くは続かず、金曜日の雇用統計でかならず下げてくるのでそこまでにはロングは全て決済する予定です。 https://t.co/nVo9N59nZz https://t.co/u813oJUfsR,19,0,1511,525,https://twitter.com/KINKUMACH/status/1564532573673750528,19
1564532076178599937,yoyoyochanyo,2022-08-30 08:34:49+00:00,やっぱ上じゃん！って個人が買い始めてから一呼吸おいて～からかなあ。メインイベントは週末の雇用統計かしら？,10,0,244,248,https://twitter.com/yoyoyochanyo/status/1564532076178599937,10
1564530002359529472,dovedovepigeon,2022-08-30 08:26:34+00:00,#yans2022 で発表した[P1-8] kNN機械翻訳のためのTransformerデコーダ最終層の中間表現の可視化・統計的分析が奨励賞を受賞しました！これからも精進します💪💪💪,56,8,204,181,https://twitter.com/dovedovepigeon/status/1564530002359529472,64
1564529999289499649,ashura_mico,2022-08-30 08:26:34+00:00,なんか、為替動き不安定じゃないですか？激しいというか。少なくとも金曜の雇用統計→来週月曜のレイバーデイ終わるまでこんなもんなんかなぁー,30,0,1392,675,https://twitter.com/ashura_mico/status/1564529999289499649,30
1564524917147959297,cuQTVM78TRGlA0S,2022-08-30 08:06:22+00:00,"@akahiguma ひぐまさん、こんにちは😊　３０日猫さん📫です。　【人口動態統計速報死亡者数　令和４年6月分】6月の死亡者数：11,481人6月迄の超過死亡者数：86,255人(2021年：77,448人)https://t.co/1g0oZpjTQz https://t.co/V0NFazaisR",10,3,1207,1839,https://twitter.com/cuQTVM78TRGlA0S/status/1564524917147959297,13
1564568672529633281,Sonsaww,2022-08-30 11:00:14+00:00,プロのプログラマーになるための「地図」を提供してくれる。初心者向けの学習方法はもちろん、仕事の見つけ方についても広く浅く書かれている。 #駆け出しエンジニアと繋がりたい #プログラミング初心者 https://t.co/2W0shPhwQp,13,0,1300,1034,https://twitter.com/Sonsaww/status/1564568672529633281,13
1564535450760527872,W8Systems,2022-08-30 08:48:13+00:00,"プログラミングの豆知識④🍃プログラミングを学んだ先に付ける職種一覧Web系プログラマー,アプリケーションプログラマー,オープン系プログラマー,インフラ系プログラマー等多岐に渡ります💡#プログラミング初心者  #プログラミング学習 #プログラミング#駆け出しエンジニア",11,0,74,19,https://twitter.com/W8Systems/status/1564535450760527872,11
1564531333551886336,FRONTALICE31337,2022-08-30 08:31:52+00:00,"CEDEC公演""伝わらないのは誰のせい？ゲーム演出フィードバックの仕方""ゲーム演出フィードバックと記載あるものの、デザイナーやプログラマーなど、色んな人と関わるプランナーには汎用的に役立つモメない分かりやすい意見の出し方、という感じでとりあえずプランナー氏はみんな見た方がいいと思う",15,7,1013,1139,https://twitter.com/FRONTALICE31337/status/1564531333551886336,22
1564523323266039810,eeeeg_jp,2022-08-30 08:00:02+00:00,非プログラマーの方に「大切な能力ってなんですか？」って聞かれた際に、「ググり力」と答えるんですが、ウケ狙いだと思われることが多々あります🧐本当なんです笑#プログラマ #エンジニア #プログラミング #駆け出しエンジニアと繋がりたい,13,1,43,1,https://twitter.com/eeeeg_jp/status/1564523323266039810,14
1564523323064602624,GEEKJOB,2022-08-30 08:00:02+00:00,今の時代、転職はプログラマーのキャリアアップの一手段なのだ！どんな実績があると次に繋がりやすいのか🤔駆け出しの頃から参考にしておこう！ITエンジニアの中途採用、高評価な実務経験は？ 採用担当者300名を対象とした調査結果https://t.co/XPTyiwRv1w @codezine #駆け出しエンジニアと繋がりたい,12,0,1014,581,https://twitter.com/GEEKJOB/status/1564523323064602624,12
1564512864714768384,sui_hoshiyadori,2022-08-30 07:18:28+00:00,@urokuta_ja この表を作った人があんまり知識が無いだけな感じにもみえる随分と前からAIは画像と相性が良いと言われているし、逆にプログラマーをAIに置き換えるなんてほぼ無理って現場の人ならわかると思う,82,17,1082,1175,https://twitter.com/sui_hoshiyadori/status/1564512864714768384,99
1564502512253542400,superponime,2022-08-30 06:37:20+00:00,プログラマーにAIのお鉢が回ってきた時にどんな醜態を晒すかみんなよく見といてくれ,27,3,862,283,https://twitter.com/superponime/status/1564502512253542400,30
1564499363656712192,Maetona,2022-08-30 06:24:49+00:00,25年前のゲームですが「トップスケーター」のカメラ制御はマジで天才プログラマーのなせる技。ゲーム開発において、こういう感覚的な部分は企画ではどうしようもない領域なのでリスペクトしかないです。#ゲーム開発 https://t.co/yQ3FCnM5cW,25,11,1115,1583,https://twitter.com/Maetona/status/1564499363656712192,36
1564498990330269696,ArdaijArarp,2022-08-30 06:23:20+00:00,元フリーターからITエンジニア転職して頑張ってます！目標は独立して一人でバリバリ稼ぐこと！#プログラマー #駆け出しエンジニアと繋がりたい,33,1,72,0,https://twitter.com/ArdaijArarp/status/1564498990330269696,34
1564445141058072576,bigmame7777,2022-08-30 02:49:22+00:00,@RadioOkinawa864 某銀行系でプログラマーをしてた時に専門用語で説明して銀行の事務の人に絶句されました。,10,0,181,2791,https://twitter.com/bigmame7777/status/1564445141058072576,10
1564444773049856000,Koke1024,2022-08-30 02:47:54+00:00,世界中のプログラマーの仕事はとっくに全部AIに奪われているけどプログラマー以外にバレないようにうまくごまかしてる,10,2,1504,2306,https://twitter.com/Koke1024/status/1564444773049856000,12
1564416129703223296,aichiilovepop,2022-08-30 00:54:05+00:00,mimicのヒアリングを受けたイラストレーターのたんたんめん先生のツイートを見れば、mimicはアドバイザー側にもプログラマー側にも善意しかなかったってはっきりわかると思います。 https://t.co/9h46xxilzO,12,2,1175,1498,https://twitter.com/aichiilovepop/status/1564416129703223296,14
1564414534651367424,interlab_inc,2022-08-30 00:47:45+00:00,おはラボ🤖#エンジニア #プログラマー 、そして皆々様。いきなりですが皆さん。出かける前は天気予報をチェックしていますか？天候がかわりやすいこの季節。ゲリラ豪雨に負けるな…🥺#企業公式が毎朝地元の天気を言い合う #企業公式夏のフォロー祭 #企業公式相互フォロー #企業公式つぶやき部,39,1,1471,1503,https://twitter.com/interlab_inc/status/1564414534651367424,40
1564408557524615170,i_like_ruby,2022-08-30 00:24:00+00:00,服装に自信がない #プログラマー 必見！#エンジニア 向けブランド！#プログラミング#プログラミング学習#プログラミング初心者#プログラミング初学者#駆け出しエンジニアと繋がりたい#駆け出しエンジニアとつながりたい#プログラミング初心者と繋がりたい#SUZURIhttps://t.co/EMoY6fDmRH,20,0,460,110,https://twitter.com/i_like_ruby/status/1564408557524615170,20
1564397642825678853,Michiaki,2022-08-29 23:40:37+00:00,@ebiebi_pg ゲームプログラマーの方がアルゴリズムとか基礎的なプログラムスキルは絶対上ですよねー。,24,4,939,1311,https://twitter.com/Michiaki/status/1564397642825678853,28
1564373084655603712,seimei7777,2022-08-29 22:03:02+00:00,まさかのライブシーンまで用意されてるとは凝ってるのです。しかしプログラマーにレイヤーや司会だけでなくライブまでやらせるとかどんだけブラックなの…（笑）。#風都探偵 #FUUTOPI #仮面ライダーW https://t.co/NKWYqR5L5F,12,1,1691,1699,https://twitter.com/seimei7777/status/1564373084655603712,13
1564365534728441856,yokko_work,2022-08-29 21:33:02+00:00,最近の自動生成ツールは本当に優秀。「プログラマーとデザイナーは人にしかできない」という前職社長の名言にもついに陰りが…！と震えていたけど、みちぽさんが震えを止めてくれた！愛を込められるのは人だけ💓今日も愛をこめて制作していくよ🥰 https://t.co/4NTFo57Bk2,15,2,518,431,https://twitter.com/yokko_work/status/1564365534728441856,17
1564359595128418304,chmo8989,2022-08-29 21:09:26+00:00,おはようございます。Pythonからスタートです。「文系プログラマーのためのPythonで学び直す高校数学」第5章　行列　入ったところ前章のベクトルは、今後もっと詳しく知りたいと感じた。職場で始業まで、応用情報処理技術者試験勉強。過去問とテキスト職場の休憩中など、隙間にPythonの勉強,20,0,320,340,https://twitter.com/chmo8989/status/1564359595128418304,20
1564275720431747072,akirako310,2022-08-29 15:36:09+00:00,#Gcom #まったく新しい宇宙創造論 にてデバッガー役を演じて下さった #園田シンジ さん。佐藤演じるプログラマーの相方。とても心強かったです。実はこれまで私は舞台の本番前にはいつも緊張が過ぎてそれはそれはひどい状態だったのですが、気付けば今回それが全く無かったのです。。 https://t.co/w0hBdtLXFQ,15,0,136,249,https://twitter.com/akirako310/status/1564275720431747072,15
1564269910624129025,hanzawa108,2022-08-29 15:13:04+00:00,~動画編集ソフト開発進捗~・編集した動画から「明るさ・コントラスト・そのシーンの重要度」などを元にサムネイル画像候補を表示する機能を実装youtubeのサムネイル画像に使うことを想定しています#動画編集者と繋がりたい #動画編集 #プログラミング #プログラマー #Python https://t.co/qNU61uzRlh,17,0,343,331,https://twitter.com/hanzawa108/status/1564269910624129025,17
1564263178162167808,web611544971,2022-08-29 14:46:18+00:00,【プログラマー志望に厳しい先生の名言】プログラマーはキラキラしているイメージあるけど現実はそうではないよ。#職業訓練#プログラマー#プログラミング初学者と繋がりたい #駆け出しエンジニアと繋がりたい,36,0,1302,757,https://twitter.com/web611544971/status/1564263178162167808,36
1564253568592670725,tarou2355,2022-08-29 14:08:07+00:00,@sannsi_suimei @U_Yawata 今後拒否する権利を設けるべきかはともかく、現在はない｢拒否する権利｣を認めた場合、逆にAI学習をさせたいプログラマーの権利が制限されてしまいます個人的には、そこまでAI学習を嫌うならそもそも公表しなければいいのではと考えてしまいます,13,4,3,19,https://twitter.com/tarou2355/status/1564253568592670725,17
1564568109465362437,kk_muscle0214,2022-08-30 10:58:00+00:00,フレームワークは脳内ショートカットキー的なイメージ,16,0,1096,1093,https://twitter.com/kk_muscle0214/status/1564568109465362437,16
1564530864964284416,uha_blog,2022-08-30 08:30:00+00:00,【 #Java のフレームワーク】・Spring Framework・Jakarta EE・Apache Struts・Apache Wicket・Play Framework・JSF（JavaServer Faces）#駆け出しエンジニアと繋がりたい #プログラミング初心者,12,0,113,93,https://twitter.com/uha_blog/status/1564530864964284416,12
1564530804260085760,pre_con_noto,2022-08-30 08:29:45+00:00,今後の予定。①ざらいで与件と設問に取り掛かる視点を身に着ける。②解答に必要な一次知識のインプット、③設問と知識を繋げるフレームワークの練習、④③を元にキーワード抽出＋解答作成練習。①を早くクリアしないと‥,10,0,297,292,https://twitter.com/pre_con_noto/status/1564530804260085760,10
1564491842162692096,wevillage2022,2022-08-30 05:54:56+00:00,CSSが苦手で最近手を付けるの完全に避けてる…CSSのフレームワークはBootstrapとTailwindという2つがメジャーな様だけど、デザインセンスもないならBootstrapの方が向いてるのかな？🤔🤔🤔#駆け出しエンジニアと繋がりたい #プログラミング初心者 #プログラミング初学者 #css #bootstrap #tailwind https://t.co/mTDdxhJAgK,24,0,21,1,https://twitter.com/wevillage2022/status/1564491842162692096,24
1564443303155625986,wanchanmask,2022-08-30 02:42:04+00:00,フロントエンドはReactから入ったし、MuiとかUIフレームワーク使うことした考えてこなかったから、DOMエレメントの基本操作がわかっていない。だからrefの使い方、というかユースケースがわかってない。近年の駆け出しフロントエンジニアなんてこうなってしまうやろな。ワイのことです。,124,7,111,150,https://twitter.com/wanchanmask/status/1564443303155625986,131
1564408934668304384,snfknz,2022-08-30 00:25:29+00:00,フレームワーク　ソロ:-7点5色のフレームを条件に合うよういかに連鎖させるかソロだと5×5の範囲制限も点数に影響します面白いかと言われると微妙なのに絶対またやりたくなるやつ…不思議ですね https://t.co/xqjATuP2vf,33,0,98,121,https://twitter.com/snfknz/status/1564408934668304384,33
1564381665530609666,takilogloglog,2022-08-29 22:37:08+00:00,人間は「具体→抽象→具体」の繰り返しで学習していくけど、このフレームワーク自体を具体に落とし込んだのが「メモの魔力」で紹介されている「ファクト→抽象化→転用」だと思う。素通りせずに日常をアイデアに変える。こころに響く言葉❣️#メモの魔力 #具体抽象トレーニング #朝活 #読書,12,1,473,428,https://twitter.com/takilogloglog/status/1564381665530609666,13
1564380530917150720,keigo_chanema,2022-08-29 22:32:38+00:00,おはようございます！考え方はヒトそれぞれだが組織であればゴール設定は統一していかなければいけないと考えてます。フレームワークがずれれば結果プロセスが良くてもずれてしまう。だからこそ組織は統一してチームで動きたいですね。今日も1日よろしくお願いします。,46,0,1700,742,https://twitter.com/keigo_chanema/status/1564380530917150720,46
1564372323515437056,nekoallllergy,2022-08-29 22:00:01+00:00,#DeepLearning フレームワークの #Keras に同梱されているサンプルのデータセットは7つです。#機械学習 #Python #プログラミング初心者 #プログラミング初心者と繋がりたい  詳しくはこちらから↓https://t.co/3L461kmy1k https://t.co/Wi7clLfqH1,12,0,172,102,https://twitter.com/nekoallllergy/status/1564372323515437056,12
1564360250836148224,hasire_kinjiroh,2022-08-29 21:12:02+00:00,『コミュニティ・オーガナイジング』#鎌田華乃子 #読書好きな人と繋がりたい コミュニティを作っていく際のフレームワークが分かりやすい上によくできています。仲間を巻き込み話し合い話を広げていく実践への準備には充分な一冊。https://t.co/Kr8qRZ48Qw,13,0,1610,747,https://twitter.com/hasire_kinjiroh/status/1564360250836148224,13
1564358497239572480,sou_yarunoda,2022-08-29 21:05:04+00:00,DRINKって書いて、RとNが出てこないまま時間が過ぎる。フレームワークに頼りすぎると我を失う隣にも引き出しあるって🗄おや、SECHIモデル、そこにいたのか…,16,0,294,427,https://twitter.com/sou_yarunoda/status/1564358497239572480,16
1564355976056250370,kemarema7819,2022-08-29 20:55:03+00:00,『地頭がいい』って言われたい。だから地頭を考えてみたよ。これ3つの思考の掛け合わせなんだね。結論から考える【仮説思考力】全体から考える【フレームワーク思考力】単純に考える【抽象化思考力】偏差値よりも地頭。こっちの方が言われて嬉しいよね。それでは一つずつ簡単にまとめたから見てみて。,77,24,1717,733,https://twitter.com/kemarema7819/status/1564355976056250370,101
1564231141523324929,fwAHfM3GXgUuluw,2022-08-29 12:39:00+00:00,今日の振り返り　108日目学習時間:5時間　合計:532時間復習ポートフォリオ案考えたりするのいいな！でも未だにhtml cssあたり最近やってないから不安なんよな〜皆さんおすすめのフレームワークとかあります？,19,0,172,169,https://twitter.com/fwAHfM3GXgUuluw/status/1564231141523324929,19
1564211082389901312,s_supporter2017,2022-08-29 11:19:18+00:00,うえで、民間の皆さんと財政フレームワークの話をしていかなければならないという風に思っています。」こりゃ”候補地を決める→選挙に再選→建設の具体化は先延ばし作戦”だな。,16,3,1670,2519,https://twitter.com/s_supporter2017/status/1564211082389901312,19
1564188930580176896,skill_up_Uni,2022-08-29 09:51:16+00:00,『雲雨傘の論理』説得力ある提案をサポート✨使いこなして欲しいフレームワークです🤗雲:事実雨:解釈傘:アクションポイントは事実/解釈/アクションの3つを揃えて明確に区別する🤗よくある失敗は事実と解釈が混同してること😨『その案でいこう！』と言われることを願ってます☺️#雲雨傘,32,0,1807,2782,https://twitter.com/skill_up_Uni/status/1564188930580176896,32
1564178725708890112,angrychloeEU,2022-08-29 09:10:43+00:00,GUIライブラリってwebアプリケーションには必要ないんですかね？あと、ネイティブアプリケーションについて調べるとフレームワークに関する記述が見当たらないんですけど、GUIライブラリがそれに当たるって認識で合ってます？#駆け出しエンジニアと繋がりたい ＃プログラミング初心者と繋がりたい,12,0,38,39,https://twitter.com/angrychloeEU/status/1564178725708890112,12
1564139753548627968,mi_chan0922k,2022-08-29 06:35:52+00:00,昨日は隠れ家日曜相席ボードゲーム会に参加しました^ ^「リビングフォレスト」「ビール侯爵」「フレームワーク」を遊びました(*'▽'*)リビングフォレストは出足遅れて負けちゃいましたT^Tビール侯爵は銀行の力を借りてお金の差で１位！手札に宮殿３枚来た時どうしようかと思った^_^; https://t.co/9yR8jylnZu,27,0,1100,1027,https://twitter.com/mi_chan0922k/status/1564139753548627968,27
1564085932977823745,shoheiweb86,2022-08-29 03:02:00+00:00,最近PHPのフレームワークであるLaravelを学習してるけど、WordPressより断然難しいです。WordPressより自由度がめちゃくちゃ高いけど、その分自分で大部分を作り上げる必要がある。早くLaravelを習得して、自分の思い描いているサービスをリリースするんだ〜！😬#web制作#web開発#webデザイン,22,0,1178,227,https://twitter.com/shoheiweb86/status/1564085932977823745,22
1564076012706467841,kurodon_bodoge,2022-08-29 02:22:35+00:00,一昨日のボドゲ会は！ブレーメン🔰フレームワーク🔰コンプレットシュッテルスフッチカート🔰ブレイズ🔰リビングフォレストスペースドラゴンズ🔰でした！なんか1位率が高かった気がしなくもない😁 https://t.co/lVDqxHzAIH,16,2,119,178,https://twitter.com/kurodon_bodoge/status/1564076012706467841,18
1564040269036929024,mirainomikata1,2022-08-29 00:00:33+00:00,頭の中を整理して、物事を考えやすくする枠組みのことを「フレームワーク」と言います。ビジネスでよく使われますね。ですがこのフレームワークを組み合わせて使うことを知らない方が多いです。例えばロジックツリー×PESTロジックツリー×3Cこうする事で生産性が高い情報収集ができます。,50,0,288,225,https://twitter.com/mirainomikata1/status/1564040269036929024,50
1564015447434936320,s_komaki_nkr,2022-08-28 22:21:55+00:00,テレワークをもっと活用できないか。在宅勤務をしていると特に集団でのコラボレーションに不都合を感じます。ITツールで少しでも臨場感を出したい。テンプレが蓄積されるミロバース。フレームワークを仕込んでおくと議論をまとめていく時にとても便利と思います🤗 https://t.co/VVcgZ5KaI1,15,0,1292,1264,https://twitter.com/s_komaki_nkr/status/1564015447434936320,15
1563993829774016512,OK4P88Mj8jJqYcl,2022-08-28 20:56:01+00:00,JavaScriptフレームワークレッスンを修了しました#テックアイエス#50代からのプログラミング#プログラミング初心者,25,0,63,53,https://twitter.com/OK4P88Mj8jJqYcl/status/1563993829774016512,25
1563900894034669568,orfevere23,2022-08-28 14:46:43+00:00,#ゼロから作るDeepLearning3Step43 ニューラルネットワークの実装sinカーブ使って非線形データセット作ったり、お決まりのシグモイド関数でフィットする曲線描いたり。フレームワークの実装より数学の方に気を取られるように・笑9/3日までに終わらせてマイナビDXクエストに集中したいけど無理だ😭,16,0,250,112,https://twitter.com/orfevere23/status/1563900894034669568,16
1564569064894509057,furifuri_mono,2022-08-30 11:01:48+00:00,AIによってプログラマが不要になったらまぁ仕方ないかぁと思うけど、デバッグとかバグレポ作成は人力で、Docker盆栽とかはAIがやるからと言われたらつらい。,10,1,1961,2592,https://twitter.com/furifuri_mono/status/1564569064894509057,11
1564435129585799168,voich2014,2022-08-30 02:09:35+00:00,他の人が書いたソースをデバッグしてるんだけど、if文の中に、超長い計算式書いて、途中に &gt;= とか比較演算があって、さらに &amp;&amp; や || がいくつかあるのに、横に長くて、読めんわ！！こういうのは、いったん計算式を短めの名前の変数に入れたりして、あらかじめ計算したやつを比較しようね(*´ω｀*),16,1,578,286,https://twitter.com/voich2014/status/1564435129585799168,17
1564433333438025728,akiratanaka1111,2022-08-30 02:02:27+00:00,少し遠くに離れるとオブジェクトの形が崩れたり、はっきり見えなくなることがあります。「アドバンス」→「デバッグ設定を表示する」で、デバッグ設定を開き、検索窓に「RenderVolumeLODFactor」と入力します。この値を4くらいにすると改善されることがあります。#SecondLife #sljp #sl,22,3,274,288,https://twitter.com/akiratanaka1111/status/1564433333438025728,25
1564087288237555718,fujisawaumi,2022-08-29 03:07:23+00:00,RPGゲーム「転生したらビヨンドのインターンだった件」リリースまであと約1週間です。社内のメンバーにデバッグを依頼したところ、バグ祭りだったので絶賛修正中です。最後の力を振り絞ってプレスリリース書きます。 https://t.co/ZlN6tM1WFZ,18,2,458,314,https://twitter.com/fujisawaumi/status/1564087288237555718,20
1563895509147795456,ankopasupasu,2022-08-28 14:25:19+00:00,じゃあなんすか？俺たちチョキ陣営はトリカラバトルのデバッグ班としてタダ働きさせられたって事っすか？ https://t.co/RQ3oElR5si,74,16,76,318,https://twitter.com/ankopasupasu/status/1563895509147795456,90
1563768151472427008,atgt2022sum_sho,2022-08-28 05:59:15+00:00,デバッグ：海老、pica、FPS、追伸、直角、SHARLEYメインGM補佐：海老、SHRLEY、しゃな、picaメインGM：かわいいアザラシSpecialThanks：あんたがたに参加してくれたすべての方々#atgt2022省エネ,12,0,198,0,https://twitter.com/atgt2022sum_sho/status/1563768151472427008,12
1563647461511401473,Jay061922,2022-08-27 21:59:40+00:00,もおおｗまたもや！　なんとかしてくれ～～で、デバッグSIMをお気に入りに入れとかないとｗｗｗhttps://t.co/ZtYWGmt3XG https://t.co/JRXPLPVGtA,16,3,314,307,https://twitter.com/Jay061922/status/1563647461511401473,19
1563515367921631233,realbvoice0311,2022-08-27 13:14:47+00:00,デバッグ不足だろこんなんｗ #セインツロウ https://t.co/gjFeBnpmhN,23,11,1183,561,https://twitter.com/realbvoice0311/status/1563515367921631233,34
1563492902210510849,madogiwananami,2022-08-27 11:45:30+00:00,四画面怪奇現象スクープアクションノベル『おまえの知らない世界』第二話まで当初予定の内容を全て対応しました！現在デバッグ中…これ、内容の割にめちゃくちゃ短時間制作だったと思いますTTでも、まだ大量のおまけ部分が残っているのですが、９月上旬までには公開できそう！ https://t.co/QrWaVKWujf,12,4,1701,2232,https://twitter.com/madogiwananami/status/1563492902210510849,16
1563458431519899649,sozokobo38,2022-08-27 09:28:32+00:00,#ナゾホリ まであと3週間ということで、現地でデバッグやらなんやら。今日のハイライトは、パーティションと長机の完璧すぎるシンデレラフィットでした。思わず叫んでしまったくらいのフィット感がどれほどのものか、ぜひ現地に見に来てください。 https://t.co/vbxEtKuXFX,12,3,1021,801,https://twitter.com/sozokobo38/status/1563458431519899649,15
1563366478413369344,ab_love_rocks,2022-08-27 03:23:09+00:00,アウトキャスト勢はエイジアプデが遅れてしまうけど、逆に先にプレイできるPCなどでデバッグやってくれるって思えば無問題ですな🤔💡#コナンアウトキャスト,14,0,1207,1788,https://twitter.com/ab_love_rocks/status/1563366478413369344,14
1563306119585419268,Roza_x_k,2022-08-26 23:23:18+00:00,なんか、RPG的なゲーム世界のデバッグする夢を見た。「くそっ……国王よりも先に村の村長が世界の危機に気付いて勇者育成を始めるバグが治らん」みたいなことを言ってた。村長が先に宣言すると勇者5人くらい出来てしまって魔王が困ってた。,66,34,684,725,https://twitter.com/Roza_x_k/status/1563306119585419268,100
1563192840875679744,mu_dia01,2022-08-26 15:53:10+00:00,プレイ時間は1200時間強（メイン825サブ319消失サブ約100偽牙部屋＋α）これだけ触ってもプレミや最適化出来そうな箇所が度々見つかるので今後も緩く続けると思われデバッグじみた行動は疲れるので後続のキャラバンに任せます https://t.co/JwKOlH374Z,15,0,38,36,https://twitter.com/mu_dia01/status/1563192840875679744,15
1563164081930240001,kopei_python,2022-08-26 13:58:53+00:00,✅デイトラ中級編  DAY21【YouTubeで自分の動画がどんなライバルの関連動画として表示されているのか調べるプログラムを作ろう】try-except文、デバッグを使って課題に挑戦中。デバッグはだいぶ使いこなせるようになった。できることが増えると楽しい。#デイトラ#Python#駆け出しエンジニア,11,1,42,47,https://twitter.com/kopei_python/status/1563164081930240001,12
1563136416208801794,Tida777,2022-08-26 12:08:57+00:00,#XANA【XANA】のステーキング抽選が本日発表されます、現在最終デバッグ中みたいですね、間もなく発表ではないでしょうか!!皆さん当たりますように🎯 https://t.co/zVeMpcShFW,37,5,240,602,https://twitter.com/Tida777/status/1563136416208801794,42
1563102784450629634,chics390730,2022-08-26 09:55:19+00:00,デイトラを受講していると ver_dump()を使う時が頻発します。それでも私はまだ、使いきれていないように感じているので、もっと積極的に使っていきたいと思います。デバッグでは大丈夫なので、使いこなしたいです。#デイトラ #駆け出しエンジニアと繋がりたい,39,0,336,333,https://twitter.com/chics390730/status/1563102784450629634,39
1563043969247744001,donichi10,2022-08-26 06:01:36+00:00,見て……虚空に浮かぶマグカップ……（デバッグ中です https://t.co/GwUOFb43MI,36,9,1465,193,https://twitter.com/donichi10/status/1563043969247744001,45
1563042863377633281,pad_adzuki,2022-08-26 05:57:13+00:00,新規、復帰勢→タダでいっぱいパック配るしスーパーデッキも貰えるからやろう！！既存プレイヤー→ランクマ報酬でパック増やしてあげるけどその代わりDMポイント削除するね！！！連続ログインボーナスも無いし、スーパーデッキもあげないよ！新弾直後のデバッグ作業よろしくwww #デュエプレ,22,2,1544,1611,https://twitter.com/pad_adzuki/status/1563042863377633281,24
1563027799375433729,s2_2_2_2_2_,2022-08-26 04:57:21+00:00,か、かいじゅうはなにもみてないヨデバッグしただけ(),12,0,1747,372,https://twitter.com/s2_2_2_2_2_/status/1563027799375433729,12
1563007072962506752,sl0qSckVX4KcGrl,2022-08-26 03:35:00+00:00,こんにちは😊横浜の天気は⛅️技術試作ではデバッグをしたりしていた係長（副支部長）は製品開発に入り、PLにコスト、日程管理をメインに。コスト試算は試作単価を載せているので+15K😅最初の基板は動かないと思っていたみたい😅何故❓😇PL経験は初の模様。今日も #BABYMETAL  と共に❣️🤘🦊 https://t.co/LKClr9FqUX,65,1,865,814,https://twitter.com/sl0qSckVX4KcGrl/status/1563007072962506752,66
1562998439171960833,kaman_zora,2022-08-26 03:00:41+00:00,トライアンドエラーって、いい言葉だと思うんですよね。・『チャレンジ』じゃなくて『トライ』・『ミス』じゃなくて『エラー』なのがとても好きです。トライと聞くと、少し軽い気持ちでやってみようと思えるし、エラーならデバッグをすれば治るから、ちゃんと修復可能な感じがします。,20,1,882,869,https://twitter.com/kaman_zora/status/1562998439171960833,21
1562998162637279232,kim_gag_sa,2022-08-26 02:59:35+00:00,@corvidaepica 震災後の日本で狂信的に支持されている「批判禁止」とは、プログラムでいうと「デバッグ禁止」のような危険思想。バグまみれのままサービスインしてメンテナンスも一切するなという過激思想だった。,37,20,482,999,https://twitter.com/kim_gag_sa/status/1562998162637279232,57
1564541782721167360,div1_ses,2022-08-30 09:13:23+00:00,今日は日本橋の【muromachi cafe HACHI】でランチしました～🍝以前はカフェ利用でしたが今日は念願のランチです🍴パンはおかわり自由、食後のコーヒーも頂けて1200円ぽっきりは破格ですよね…😲店内もおしゃれでとても良い雰囲気でお気に入りです💙おすすめなので神田に来た際はぜひ🥰 https://t.co/feuKHASGO9,11,1,863,705,https://twitter.com/div1_ses/status/1564541782721167360,12
1564539954243698688,NGY_it_anken,2022-08-30 09:06:07+00:00,本日もお疲れ様でした🌷夏の終わりに近づいて、日も短くなってきましたね☺季節の変わり目の体調不良に気を付けて明日も頑張りましょう！#企業公式相互フォロー#企業公式夏のフォロー祭り#企業公式がお疲れ様を言い合う #エンジニア転職#駆け出しエンジニアと繋がりたい#フリーランス#SES,37,0,656,672,https://twitter.com/NGY_it_anken/status/1564539954243698688,37
1564538032564232194,T__yoshida96,2022-08-30 08:58:29+00:00,SES営業のこの人ふざけんてなーって人ほど仕事してる不思議,12,0,983,870,https://twitter.com/T__yoshida96/status/1564538032564232194,12
1564534663779352576,katsuyatanak877,2022-08-30 08:45:06+00:00,エンジニアと仕事してて思うのは、ググるスピードの速さ。分からない！と思ってから3秒後には検索結果は出てる。未経験と経験者の違い。#駆け出しエンジニアと繋がりたい #未経験#SEShttps://t.co/zWwwmACOnj,19,0,14,30,https://twitter.com/katsuyatanak877/status/1564534663779352576,19
1564533736531566593,anri_SES,2022-08-30 08:41:25+00:00,昨日今日有給を使い、湯河原に行ってきました！自然の中をたくさん歩いてリフレッシュできました。お土産も買えて良かったです。明日から頑張ります。 https://t.co/3k8MPdlG8I,11,0,1744,1008,https://twitter.com/anri_SES/status/1564533736531566593,11
1564517386359033856,sagi0haken,2022-08-30 07:36:26+00:00,ただの派遣ですよ。嘘ばっっっっっっっかり書きやがって！！人騙してそんなに楽しいですか？無期雇用派遣は正社員ではありません。間接雇用の派遣社員です。派遣先ではただの派遣さんとして扱われます。#無期雇用派遣#正社員型派遣#常用型派遣#技術派遣#客先常駐#SES#就活#23卒 https://t.co/3ZQI5gM5GR,11,3,434,17,https://twitter.com/sagi0haken/status/1564517386359033856,14
1564515898727075840,takayukihirota,2022-08-30 07:30:32+00:00,◆スキルアップできるのか？◆最先端案件に携われるのか？◆エンジニアとして成長できるのか？◆安定して働けるのか？皆さん疑問だと思いますが、これを全て実現できるように活動しています！気になる方はDM📩お待ちしています営業募集中#SES#エンジニア#駆け出しエンジニアと繋がりたい,12,0,1778,4955,https://twitter.com/takayukihirota/status/1564515898727075840,12
1564507520462651392,momomo_ses,2022-08-30 06:57:14+00:00,遂に発表します…私はきのこの山派です🍄！,32,0,1127,1243,https://twitter.com/momomo_ses/status/1564507520462651392,32
1564492615474905090,rensa_techmania,2022-08-30 05:58:01+00:00,エンジニアとして社外に巣立っていく後輩ちゃんの壮行会ランチしました〜！🍴何気に久々の写真投稿かもしれない😋そしてめっちゃ食後(笑)👐向こうでもふぁいと！後輩ちゃん！！  #SES #広報 #駆け出しエンジニア #エンジニア転職 #エンジニアと繋がりたい https://t.co/9gmyVHVRE4,14,0,688,412,https://twitter.com/rensa_techmania/status/1564492615474905090,14
1564492221675495424,bold_minami,2022-08-30 05:56:27+00:00,SESで…◆スキルアップできるのか？◆最先端案件に携われるのか？◆エンジニアとして成長できるのか？◆安定して働けるのか？皆さん疑問だと思いますが、これを全て実現できるように活動しています！気になる方はDM📩お待ちしています👍#SES#エンジニア#駆け出しエンジニアと繋がりたい,23,0,139,360,https://twitter.com/bold_minami/status/1564492221675495424,23
1564469493740343297,god48_,2022-08-30 04:26:08+00:00,フリーランスになる前に、転職は一度することをおすすめします！SESなどで案件変更してもいいと思いますが、歴1年でも経験があれば給料UPできるし、エンジニアにとって縦の知識も必要だけど、横の方が個人的には大事だと思ってる。#フリーランス#駆け出しエンジニアと繋がりたい#プログラミング,29,2,250,39,https://twitter.com/god48_/status/1564469493740343297,31
1564454012761477120,paruharu_ses,2022-08-30 03:24:37+00:00,おはようございます！頭が回らなくてミスをちょくちょくしっちゃってて、ご飯と睡眠の大事さを痛感しました。ご飯食べてきます,12,0,1362,978,https://twitter.com/paruharu_ses/status/1564454012761477120,12
1564448622695030790,moon_hoge,2022-08-30 03:03:12+00:00,「よわよわエンジニア2年生、意識高い系現場の旅行」SESで働く私の現場記録！✅ つよつよエンジニア多め✅ 前年同期比20%の成長率✅ 周りが技術力高すぎて、腐らないのが課題#駆け出しエンジニアと繋がりたい #ブロガーさんと繋がりたい #ブログ初心者https://t.co/ZUgA7M0Wbh,19,0,52,30,https://twitter.com/moon_hoge/status/1564448622695030790,19
1564448485272760320,mimi8_ses,2022-08-30 03:02:39+00:00,若手向けのテスト案件あります！プロパーさんであれば未経験の方でも土台のりますのでご連絡いただけるとうれしいです😢,33,1,641,457,https://twitter.com/mimi8_ses/status/1564448485272760320,34
1564443037413015552,NoticeperiodCom,2022-08-30 02:41:00+00:00,8/30【Instagram更新】随時最新の案件情報を掲載しています💁‍♀️是非ご覧ください！https://t.co/A0olwCNAFx#Java #Python #SQL #AWS #リモート #在宅ワーク #転職 #エンジニア転職 #駆け出しエンジニアと繋がりたい #企業公式相互フォロー #企業公式夏のフォロー祭り#ses #フリーランス,40,3,143,82,https://twitter.com/NoticeperiodCom/status/1564443037413015552,43
1564442657295740929,NGY_it_anken,2022-08-30 02:39:30+00:00,8/30【Instagram更新】随時最新の案件情報を掲載しています💁‍♀️是非ご覧ください！https://t.co/40DmULeEeQ#Java #Python #SQL #AWS #リモート #在宅ワーク #転職 #エンジニア転職 #駆け出しエンジニアと繋がりたい #企業公式相互フォロー #企業公式夏のフォロー祭り#ses #フリーランス,20,2,656,672,https://twitter.com/NGY_it_anken/status/1564442657295740929,22
1564433127564398593,yu_sessales,2022-08-30 02:01:38+00:00,10月から未経験要員様空いている方いらっしゃいませんか？24/365の保守運用業務で、場所は小田急線の黒川になります。単価かなり渋いですが、じっくりと力を付けたい方にはオススメの現場になります。興味ある方はリプかDMにてお願いします！#SES#SES営業,14,0,490,488,https://twitter.com/yu_sessales/status/1564433127564398593,14
1564432824412913664,manoa_lino,2022-08-30 02:00:25+00:00,採用強化に伴い、下記人材を募集しております。☆ ITエンジニア（実務経験ありの方）お心当たりのある方や、企業様がいらっしゃいましたらお気軽にご連絡ください✨#企業公式相互フォロー #SES #エンジニアと繋がりたい,13,2,1244,867,https://twitter.com/manoa_lino/status/1564432824412913664,15
1564431379936714752,rensa_techmania,2022-08-30 01:54:41+00:00,お疲れ様です🙌＼お知らせ🍀／note！第5弾！更新しました🙆‍♂️手に職をつけて自力で生きるためにエンジニアになる決心をしたということですが、心打たれましたね😌これだからエンジニアさんへの尊敬がとまらない🤦‍♀️https://t.co/2tA81aRJee#SES #広報 #駆け出しエンジニア #note #エンジニア転職,12,1,688,412,https://twitter.com/rensa_techmania/status/1564431379936714752,13
1564427296844288000,div1_ses,2022-08-30 01:38:27+00:00,おはようございます🌞最近モンハンをやり始めまして、お友達と狩りをする毎日ですがとても楽しくて充実しています🍖今月もあと2日…！ということで張り切ってまいりましょ～🚩,11,0,863,705,https://twitter.com/div1_ses/status/1564427296844288000,11
1564422570778435585,KingfootballK,2022-08-30 01:19:41+00:00,SES営業もいわゆる提案型営業は発生しますが、出来ない人がほとんどだと思うな。明らかに、炎上しそうなスケジュールや、手法をとっているPJだとした時に、「提案をしない」も一つの選択肢だと思うが、ヒアリングを入れて、何が問題なのかを把握して、問題解決の為の提案をするのも営業なので　↓,11,0,1353,21,https://twitter.com/KingfootballK/status/1564422570778435585,11
1564420137914363905,kikurin_ses,2022-08-30 01:10:01+00:00,おはようございます！にんにくと豆板醤を入れる前に写真を撮るのを忘れてました。今月ももう終わっちゃいますね！バシバシ稼働決めて行きますので、宜しくお願いします😗 https://t.co/FRye7eQBdD,16,0,740,490,https://twitter.com/kikurin_ses/status/1564420137914363905,16
1564413501241585665,asuka_ses,2022-08-30 00:43:38+00:00,おはようございます！最近涼しいから過ごしやすいですね…本日もよろしくお願いします☺️☺️,15,0,758,868,https://twitter.com/asuka_ses/status/1564413501241585665,15
1564412937749442560,shase428,2022-08-30 00:41:24+00:00,SES界隈いくらでも人は集まると思ってるフシがあるけどそういう時代じゃなくなると思うよ,14,3,1363,860,https://twitter.com/shase428/status/1564412937749442560,17
1564404465222164480,mell_pupu69,2022-08-30 00:07:44+00:00,SESって、他を経験したことがないからわからないけど、7つくらい次の案件先提示されて、面談に行けるのが実質その中の1つだとか、面談の予定すら組めないとか、面談予定だったのに話が流れるとか、よくある話なんですか？！#駆け出しエンジニアと繋がりたい,119,1,190,171,https://twitter.com/mell_pupu69/status/1564404465222164480,120
1564271292542509057,7010Rei,2022-08-29 15:18:33+00:00,#駆け出しエンジニアと繋がりたいのタグ付けてるエンジニア志望（未経験）・駆け出しエンジニア多いけど、そういう人こそ現役エンジニアで決裁権もつ人と繋がった方が得できます逆に本当に未経験・駆け出しエンジニアと繋がりたいと思っているのは、SESの皮を被った派遣会社と情報商材屋なので要注意,12,0,756,1130,https://twitter.com/7010Rei/status/1564271292542509057,12
1564258251968880641,MMPR_JPN,2022-08-29 14:26:44+00:00,みなさんこんばんはーーーーーー！！！！！！おやすみなさい😌#MMPR #企業公式相互フォロー #企業公式  #板橋区 #池袋 #千川 #SES #web制作 #コ・ワーキングスペース #ロゴ制作 https://t.co/7XWdwz8Fz5,15,0,1295,1321,https://twitter.com/MMPR_JPN/status/1564258251968880641,15
1564236336269524992,shin_tech1,2022-08-29 12:59:39+00:00,去年の今頃はSESに入りたてで、面接受かるかなぁ。これから本当に実務経験積めるだろうかとかすごく不安で悩んでた。現在は資格取得にも励めているし勉強を欠かさず継続できている。一年前と比べると状況はかなり好転しているからこのままハングリー精神で突き進みたい。,13,0,358,108,https://twitter.com/shin_tech1/status/1564236336269524992,13
1564584423211040768,Yomuyomupoo,2022-08-30 12:02:49+00:00,"この方は資本主義は悪だと思っているようだけれど、子供の扶養控除無しに子供支援に差別的所得制限されている親の中には、世の中のために尽力している人も多い。例えば、技術開発の仕事。介護医療、あらゆる分野の発展に多大な貢献をしてる。そもそも所得で仕事の""善悪""を判断できるのか？ https://t.co/FPLHsVjLIV",10,0,1366,3919,https://twitter.com/Yomuyomupoo/status/1564584423211040768,10
1564583782891798529,zetsumeiken,2022-08-30 12:00:17+00:00,お絵描きAIに絵をパクられて筆を折る絵描きが出てくるかもと杞憂めいたツイートをしてる人達が返す刀で寄ってたかって開発に協力したイラストレーターをツイッター休止に追い込んでて駄目だった　海馬が機能していらっしゃらない？,55,40,1547,4304,https://twitter.com/zetsumeiken/status/1564583782891798529,95
1564583260822577152,rune2013,2022-08-30 11:58:12+00:00,新しい開発が楽しい。プラチナの特性って、まだまだ未知だったのでは？最新のナノテクノロジーとも好相性。これは、新しい製品に出来る！,31,0,1675,1555,https://twitter.com/rune2013/status/1564583260822577152,31
1564582889152724992,ajisai_ff14,2022-08-30 11:56:43+00:00,TES Skyrimやウルティマにインスパイアされたという、2Dオープンワールド『World of Anterra』の #Kickstarter バッカーになりました既に1年以上開発していて日本語にも対応予定とあるし、トレーラー見ていると期待しちゃうな#WorldofAnterrahttps://t.co/UvBlQSW2bH,18,5,1780,3039,https://twitter.com/ajisai_ff14/status/1564582889152724992,23
1564581629968121856,fukku_RX8,2022-08-30 11:51:43+00:00,今週まだ2日目…長く感じる😭RX7開発主査の息子さんから業務のメール来てちょっとテンション上がったけど🙄そう言えば先週末車検から復活しました👏フロントツラガバはこれから詰めます🥺併せてリアも要調整… https://t.co/WWOoexk2mS,30,0,1238,1144,https://twitter.com/fukku_RX8/status/1564581629968121856,30
1564580296418140161,6467c8e9c279413,2022-08-30 11:46:25+00:00,某配信者が「Discordで開発スタッフが今年の冬までにエネ爆弱体化します」と言ってるが開発スタッフの名前は出てたのかな？もし本当に開発スタッフだという裏付けがあるのなら知りたいとこですが。「ガチで修正がはいる！」「可能性が極めて高い！」確定の話をしながら可能性とか言うてるしなーw,10,0,243,276,https://twitter.com/6467c8e9c279413/status/1564580296418140161,10
1564577848429400064,rsensui,2022-08-30 11:36:42+00:00,そういえば、以前ブランド名は出せないけど転職したい人探してる、待遇は良い。と書いたのが、先日発表したaiwaデジタル立ち上げのお仕事でした。発表終わったので改めて。。。aiwaデジタルでの営業・事業開発に興味がおありの方いらっしゃったらお声がけください。,17,9,1418,1161,https://twitter.com/rsensui/status/1564577848429400064,26
1564577475849601031,yaamatack,2022-08-30 11:35:13+00:00,お皿洗い、終わりました🙌「分解してすみずみまで洗える水筒」じゃなくて、「分解しなくてもすみずみまで洗える水筒」を開発してほしい。 https://t.co/m1vx7PK1DF,15,0,240,236,https://twitter.com/yaamatack/status/1564577475849601031,15
1564576285451763712,mlyu_miyu,2022-08-30 11:30:29+00:00,今日のイラストが気に入ったカード！テストカード可愛すぎません⁉︎ 集めたくなるー開発陣がこんな可愛い代用カードでテストプレイしてるって考えると、なんだか微笑ましいですね https://t.co/QiLW19dP1D,15,0,330,331,https://twitter.com/mlyu_miyu/status/1564576285451763712,15
1564574494894612480,chihaya0204,2022-08-30 11:23:22+00:00,大丈夫だよ。みんな。配信前だったかの開発インタビューでハッピーエンドが待ってるって言ってたから大丈夫だよ(ハッピーエンドに向かう過程は知らんけど,12,3,341,245,https://twitter.com/chihaya0204/status/1564574494894612480,15
1564573899534536705,yukkuriyattu,2022-08-30 11:21:00+00:00,"@Ones_Subaccount はい、データセットの学習に使うなどの開発目的に限り合法です。ですがミミックという開発済みのAIに出力物目的でアップロードする行為は""開発目的""に該当しないので違法となると考えています。",20,0,293,1366,https://twitter.com/yukkuriyattu/status/1564573899534536705,20
1564577978998489088,Aopon_GRF_STI,2022-08-30 11:37:13+00:00,今日の入間〜ややテイルウインド気味なのが吉と出たか降りの機体全てエンドまで来てくれました😳T-4がスピードブレーキ展開してるの良きだし最後のｽｹｼﾞｭｰﾙC-1の黒雲バックがバカカッコよすぎた😇＃入間基地 https://t.co/be4U5Y095y,13,3,628,180,https://twitter.com/Aopon_GRF_STI/status/1564577978998489088,16
1564560600339886080,n0mimono,2022-08-30 10:28:09+00:00,ミラティブではエンジニアを大募集中です！・iOS／Android／Unity・フロントエンド／バックエンド・インフラ／ストリーミング・エンジニアリングマネージャー／わかりあいテックhttps://t.co/3MdoZa4iCs,17,9,1540,899,https://twitter.com/n0mimono/status/1564560600339886080,26
1564543456093302784,ichiokuwolf,2022-08-30 09:20:02+00:00,個別相談→30万以上の高額バックエンド販売で成約率を桁違いにあげる一つのテクニックをご紹介します。それは、プレゼンに入る前に「今から”社長”だと思って話しを聞いてください」と一声かける、です。理由は”カラーバス効果”の応用でアンテナを貼らせることによって受け手の入ってくる情報量と質を,18,1,1438,98,https://twitter.com/ichiokuwolf/status/1564543456093302784,19
1564538387373395969,GIANT_KILLING_0,2022-08-30 08:59:53+00:00,バックエンドで頑張ろうと思ったらJavaScriptは絶対勉強しとかなあかんのか！！#Python#JavaScript#駆け出しエンジニアと繋がりたい#プログラミング初心者と繋がりたい#プログラミング＃エンジニア,51,5,10,13,https://twitter.com/GIANT_KILLING_0/status/1564538387373395969,56
1564525731622707200,hamaettybot,2022-08-30 08:09:36+00:00,"Day 242【PHP, MYSQL, Apache】ガチで学びたい人のためのWEB開発の基礎(バックエンド編)✅Webサーバーの基礎LOG ログの設定と確認#駆け出しエンジニアと繋がりたい",28,1,229,198,https://twitter.com/hamaettybot/status/1564525731622707200,29
1564444340973600768,_everb1ue,2022-08-30 02:46:11+00:00,(デザインもフロントもバックエンドも撮影も奥田さん？目ん玉飛び出た🙄),12,0,97,290,https://twitter.com/_everb1ue/status/1564444340973600768,12
1564420529029009408,react_nextjs,2022-08-30 01:11:34+00:00,React(Next.js)の勉強は個人ブログが終わったら一旦終わりにして、10月からは来年に向けてインフラ、ネイティブ、バックエンドの知見を並行して鍛えていく。,16,0,946,215,https://twitter.com/react_nextjs/status/1564420529029009408,16
1564371844387717121,edu_haruki,2022-08-29 21:58:06+00:00,今どき、・Python なんか、ガキにやらせとけ。・おれは機械学習なんかわからん・JavaScript？フロントエンジニアに頼んでよ。・SQL、バックエンドはわからないよ…なんて言うプログラマは、不要でしょう。#プログラミング初心者#駆け出しエンジニアと繋がりたい,17,0,382,88,https://twitter.com/edu_haruki/status/1564371844387717121,17
1564253002252582912,aRu_engineer,2022-08-29 14:05:52+00:00,AWSの基盤構築から、Nuxt.jsとLaravelによる、フロントエンドとバックエンドともに開発できます！なんちゃってフルスタックみたいになってますが、色々やってましたwこのスキルでフルリモートできる会社ありますか？,45,2,197,187,https://twitter.com/aRu_engineer/status/1564253002252582912,47
1564234828664283138,BubblerKJMT,2022-08-29 12:53:39+00:00,WEBデザイナーがBubbleをやるべき2つの理由。①バックエンド側は得意だけど、フロント周りが苦手なBubblerから仕事の依頼が来る（実際にそういうBubblerは結構いる）②バックエンド側を勉強すれば、一人で全て構築できてしまうデザイン専門のBubblerという人はあまり見かけないので、チャンス！,17,0,148,134,https://twitter.com/BubblerKJMT/status/1564234828664283138,17
1564233558172274688,tacck,2022-08-29 12:48:36+00:00,みなさん、ご参加ありがとうございました！！次回のテーマはバックエンド的な感じにしたいと思います！自分がネタ出せるかわかりませんが！！ #ゆるWeb札幌,12,2,1214,1857,https://twitter.com/tacck/status/1564233558172274688,14
1564207682784882688,Soloware_,2022-08-29 11:05:47+00:00,NestJS+Reactの案件に入っている友人がここ最近、毎日家に来てプログラミングの質問してくれるんですがJavaやっててよかったとマジで思った😋Nest一切触ったことないけど、ほぼわからんとこなかったオブジェクト指向でバックエンドやっとくのはマジでオススメです#駆け出しエンジニアと繋がりたい,31,0,816,279,https://twitter.com/Soloware_/status/1564207682784882688,31
1564191642856427521,wakatchi_tech,2022-08-29 10:02:03+00:00,技術者の区分けはアプリ、インフラ、データ(DBA、データ分析)、運用ぐらいしか考えたことがない。ML/AIはアプリかな。SREやDevOpsも絡むとアプリとインフラの境界もなくなってる。フロントエンドとバックエンドの分け方は得意領域であって、技術者の境界ではないと思うな#プログラミング初心者,12,0,340,280,https://twitter.com/wakatchi_tech/status/1564191642856427521,12
1564169582285185024,hamaettybot,2022-08-29 08:34:23+00:00,"Day 241【PHP, MYSQL, Apache】ガチで学びたい人のためのWEB開発の基礎(バックエンド編)✅Webサーバーの基礎REDIRECT URLのリダイレクトREDIRECT 301と302#駆け出しエンジニアと繋がりたい",16,0,229,198,https://twitter.com/hamaettybot/status/1564169582285185024,16
1564099945329983489,wevillage2022,2022-08-29 03:57:41+00:00,まだJavaScriptの1%位しか触れてないのはわかるけど、CSSとか見た目を整えるよりも、こっちの学習の方が好きかも。これはフロントエンドではなく、バックエンドの方が向いているってことなのか???🤔#駆け出しエンジニアと繋がりたい #プログラミング初心者 #プログラミング初学者 #javascript #css,29,0,21,1,https://twitter.com/wevillage2022/status/1564099945329983489,29
1564072552070533122,old_pgmrs_will,2022-08-29 02:08:50+00:00,FlutterFlow：ローコードでFlutterベースのプロジェクト作成→native app開発ツール。mobileだけでなくMac/Win/Linuxアプリも作成可能。言語はDart、バックエンドがFirebaseなら色々捗ります。push通知や決済連携など各種サービス連携もOK#駆け出しエンジニアと繋がりたい https://t.co/khPvnKDIkh,14,0,593,580,https://twitter.com/old_pgmrs_will/status/1564072552070533122,14
1564030954062041088,jonio1218,2022-08-28 23:23:32+00:00,今週はバックエンド週だからLaravelとPHPを頑張ろうなぜか途中でエラーになるけどネットの情報が漏れているのかな？謎だwordpressサイトをヘッドレスにするのは昨日完成したからその内サイトをちゃんと作らないといけない#駆け出しエンジニアとつながりたい,44,1,861,112,https://twitter.com/jonio1218/status/1564030954062041088,45
1564025541636030464,pypy1225,2022-08-28 23:02:01+00:00,バックエンド専門ですが、フロントエンド奥が深すぎる！バックエンドは要件定義さえしっかりやれば作業自体は明確だけどフロントエンドは底なし沼や。#駆け出しエンジニアと繋がりたい,40,0,728,608,https://twitter.com/pypy1225/status/1564025541636030464,40
1564022101262090247,tomoki_11_05,2022-08-28 22:48:21+00:00,【バックエンドはチラ見せすべし】最近は情報発信する人が増えてるので、無料相談でセールスかけられるのはお客さんみんなが知ってます。なのでバックエンドの存在を相手に認知させた上で無料相談した方が意外とセールスしやすいですね。特にセールス苦手な人こそバックはオープンにしましょう。,11,0,1396,248,https://twitter.com/tomoki_11_05/status/1564022101262090247,11
1564010005539393537,hisayuki_ik,2022-08-28 22:00:17+00:00,おはようございます。セルフハッカソン4日目フロントエンドやろうとしてたらバックエンド側のDocker環境でやりたい事が実現できなかったのでvenvでリプレイスすることにしました。本日は月曜日ですね。オフショア対応と客先営業も合わせてやっていきます。本日も頑張ってまいりましょう。,30,0,959,1018,https://twitter.com/hisayuki_ik/status/1564010005539393537,30
1563994335871307776,shinji_senkusya,2022-08-28 20:58:01+00:00,【コンテンツ作成の流れ】➊誰の悩み解決をしたいか決める➋ノウハウを整理してまとめる➌似たような商品との差別化をしコンセプトを決める➍PDFや動画でコンテンツ化➎商品名を決めてセールスページ作成➏バックエンドを決める➐仕組み化を作成。➍は動画がオススメ。文字より音声が伝わりやすいから,59,17,1185,808,https://twitter.com/shinji_senkusya/status/1563994335871307776,76
1563888030535979008,oskmr_,2022-08-28 13:55:36+00:00,個人開発でアプリ作るのにバックエンドできないし雑に公開されてるAPI使ったら癖強すぎて泣いてるアホの典型みたいな開発スタイル,19,0,993,596,https://twitter.com/oskmr_/status/1563888030535979008,19
1563791394656768002,FGKU7MsmxdhalCJ,2022-08-28 07:31:36+00:00,awsの設計構築業務やってて思うけど、awsでインフラの構築できて、Linux構築できてスクリプトとか書けて、バックエンドの言語も2つくらい書けて、dockerもできてGitHub使えてインフラのコード化もできるみたいな1部の天才達はどんな学習してどんなプロジェクトを経験してきたのかマジで教えてほしい。,10,1,86,39,https://twitter.com/FGKU7MsmxdhalCJ/status/1563791394656768002,11
1563782945617260544,pypy1225,2022-08-28 06:58:02+00:00,どこまでがフロントでどこからがバックエンドなのか機能の切り分けはかなり大事。ここが曖昧だと余計な実装をしてしまうので注意。チーム内で役割が分かれている場合は、積極的に振っていこう。#駆け出しエンジニアと繋がりたい,23,0,728,608,https://twitter.com/pypy1225/status/1563782945617260544,23
1563755763276754944,hamaettybot,2022-08-28 05:10:01+00:00,"Day 240【PHP, MYSQL, Apache】ガチで学びたい人のためのWEB開発の基礎(バックエンド編)✅Webサーバーの基礎.htaccessとは?.htaccessを使った設定#駆け出しエンジニアと繋がりたい",33,0,229,198,https://twitter.com/hamaettybot/status/1563755763276754944,33
1563723042273955840,RoadIT_fukuda,2022-08-28 03:00:00+00:00,バックエンドの僕がフロントの実装やっていたりレイアウト決めたり‥😂たまに、自分が何者か分からなくなります！！😆でも、それもこれもスキルアップには繋がってる🔥今後、求められるスキルセットも変わってくるのでは？？,64,0,468,490,https://twitter.com/RoadIT_fukuda/status/1563723042273955840,64
1563695358768779266,frontend_fr,2022-08-28 01:10:00+00:00,今の私の現場ってフロントはNext.js/TSでバックエンドはGoでインフラはAWSなんですが、AWSのアカウントも発行してくれるわ、フロントのタスクが終われば全然バックエンド開発に携わっていいわとかでかなり神がかってる✨#駆け出しエンジニアとつながりたい #プログラミング初心者,13,0,48,0,https://twitter.com/frontend_fr/status/1563695358768779266,13
1563545185232904195,tomogogo0,2022-08-27 15:13:16+00:00,バックエンドで売りたい商品の情報を小出しにツイートするといいですよ。ピンポイントで重要なノウハウを書けば読者は「気になる！もっと知りたい！」と思ってくれます。ツイートに反応してくれるということは、商品を買ってくれる可能性も高いです。,11,0,1821,2181,https://twitter.com/tomogogo0/status/1563545185232904195,11
1563542204622458887,sakikodayo,2022-08-27 15:01:25+00:00,mintページ、バックエンドを含めても多分5日も掛かってないと思うので、それにしてはまぁまぁなクオリティなのでは？って自分でも思っている節があります🥰,29,3,216,212,https://twitter.com/sakikodayo/status/1563542204622458887,32
1563514699110838273,ura_markedaiki,2022-08-27 13:12:07+00:00,プロモはぶっちゃけ、ビッグアイディア(コンセプト)で全てが決まる。無料プレゼント〜バックエンド販売まで、一貫してビッグアイディアで貫き通すことが大事。後は無料プレゼントの質。教育とかテンプレじゃない。渾身のコンテンツを作る。圧倒的に価値の高いコンテンツを作る。20%の人が熱狂的な,10,0,35,21,https://twitter.com/ura_markedaiki/status/1563514699110838273,10
1563467121979686913,aochuki75,2022-08-27 10:03:04+00:00,こちらはバックエンドに生クリームのリソースを使いすぎてフロントの生クリームが足りなくなってしまった旦那さんのお誕生日ケーキです https://t.co/qY2vD4WPDH,17,0,159,145,https://twitter.com/aochuki75/status/1563467121979686913,17
1563466669774610433,hamaettybot,2022-08-27 10:01:16+00:00,"Day 239【PHP, MYSQL, Apache】ガチで学びたい人のためのWEB開発の基礎(バックエンド編)✅Webサーバーの基礎ALIAS URLをマッピングディレクティブとコンテキストDirectory セクション理解度チェック#駆け出しエンジニアと繋がりたい",28,0,229,198,https://twitter.com/hamaettybot/status/1563466669774610433,28
1564560600339886080,n0mimono,2022-08-30 10:28:09+00:00,ミラティブではエンジニアを大募集中です！・iOS／Android／Unity・フロントエンド／バックエンド・インフラ／ストリーミング・エンジニアリングマネージャー／わかりあいテックhttps://t.co/3MdoZa4iCs,17,9,1540,899,https://twitter.com/n0mimono/status/1564560600339886080,26
1564444340973600768,_everb1ue,2022-08-30 02:46:11+00:00,(デザインもフロントもバックエンドも撮影も奥田さん？目ん玉飛び出た🙄),12,0,97,290,https://twitter.com/_everb1ue/status/1564444340973600768,12
1564443303155625986,wanchanmask,2022-08-30 02:42:04+00:00,フロントエンドはReactから入ったし、MuiとかUIフレームワーク使うことした考えてこなかったから、DOMエレメントの基本操作がわかっていない。だからrefの使い方、というかユースケースがわかってない。近年の駆け出しフロントエンジニアなんてこうなってしまうやろな。ワイのことです。,125,7,111,150,https://twitter.com/wanchanmask/status/1564443303155625986,132
1564416684542152704,zx750ppa,2022-08-30 00:56:17+00:00,"続！週刊1/1スケールグロム　vol,7ex実走行してみての不具合解消とカスタム編リアタイヤのtt91をtt93gpへ交換+歪んだフロントホイール交換  4.5万リアサスをキタコへ交換　1.0giviトップケース27㍑　7700曲がったハンドル+バーエンド交換　1800 https://t.co/x2cNito6OF",10,0,118,222,https://twitter.com/zx750ppa/status/1564416684542152704,10
1564402523900825600,engineer_start,2022-08-30 00:00:01+00:00,https://t.co/IL0D6OM9Ck 「超効率的Web制作フロントエンド転職ロードマップ」、明日まで500円で販売します！✅転職の費用をなるべくかけない✅業界未経験でもスムーズに転職して成長を後押し#駆け出しエンジニアと繋がりたい #プログラミング初心者 #エンジニア転職 #フロントエンド,18,0,155,359,https://twitter.com/engineer_start/status/1564402523900825600,18
1564397566191890432,yuita_0360,2022-08-29 23:40:19+00:00,8/292.5時間(total:227時間)Rails実践　基礎編javascript書籍フロントエンドの勉強のために今日からjavascriptについて学んでいきます！基本的なところをさらっと見てまずは概要をしっかり掴んでいきます！#RUNTEQ #1000時間チャレンジ,14,0,118,111,https://twitter.com/yuita_0360/status/1564397566191890432,14
1564371844387717121,edu_haruki,2022-08-29 21:58:06+00:00,今どき、・Python なんか、ガキにやらせとけ。・おれは機械学習なんかわからん・JavaScript？フロントエンジニアに頼んでよ。・SQL、バックエンドはわからないよ…なんて言うプログラマは、不要でしょう。#プログラミング初心者#駆け出しエンジニアと繋がりたい,17,0,382,88,https://twitter.com/edu_haruki/status/1564371844387717121,17
1564253002252582912,aRu_engineer,2022-08-29 14:05:52+00:00,AWSの基盤構築から、Nuxt.jsとLaravelによる、フロントエンドとバックエンドともに開発できます！なんちゃってフルスタックみたいになってますが、色々やってましたwこのスキルでフルリモートできる会社ありますか？,45,2,197,187,https://twitter.com/aRu_engineer/status/1564253002252582912,47
1564234828664283138,BubblerKJMT,2022-08-29 12:53:39+00:00,WEBデザイナーがBubbleをやるべき2つの理由。①バックエンド側は得意だけど、フロント周りが苦手なBubblerから仕事の依頼が来る（実際にそういうBubblerは結構いる）②バックエンド側を勉強すれば、一人で全て構築できてしまうデザイン専門のBubblerという人はあまり見かけないので、チャンス！,17,0,148,134,https://twitter.com/BubblerKJMT/status/1564234828664283138,17
1564200290039263232,sho_yan_osaka,2022-08-29 10:36:25+00:00,私も最初はフロントエンドかはサーバーサイドか悩みました。しかし、大阪はフロントエンドで求人だしているところ少ない &amp; 結局、どっちの知識もいるで、この年齢ではサーバーサイド一択でした。#駆け出しエンジニアと繋がりたい,14,1,299,313,https://twitter.com/sho_yan_osaka/status/1564200290039263232,15
1564200112355942400,Nekoya3_,2022-08-29 10:35:42+00:00,#多分私しかやっていない スコラボのフロントエンドの開発....,11,2,559,986,https://twitter.com/Nekoya3_/status/1564200112355942400,13
1564198180270403584,_calamarify,2022-08-29 10:28:02+00:00,🎉 勉強会に登壇します 👏「THREE.jsを用いたKV作成について」というタイトルで話します。オンラインで開催なので広島県外の人もたくさん参加してください。先着30人だそうです。---広島フロントエンド勉強会 Vol.30 https://t.co/SAgVzyr6rS #ヒロフロ,38,8,777,1818,https://twitter.com/_calamarify/status/1564198180270403584,46
1564191642856427521,wakatchi_tech,2022-08-29 10:02:03+00:00,技術者の区分けはアプリ、インフラ、データ(DBA、データ分析)、運用ぐらいしか考えたことがない。ML/AIはアプリかな。SREやDevOpsも絡むとアプリとインフラの境界もなくなってる。フロントエンドとバックエンドの分け方は得意領域であって、技術者の境界ではないと思うな#プログラミング初心者,12,0,340,280,https://twitter.com/wakatchi_tech/status/1564191642856427521,12
1564170477655838721,KZg1d,2022-08-29 08:37:57+00:00,3か月働いてみて、軽微な修正しかやっていませんが、やっぱりコード書くのが楽しいです。デザインも基本的な技術は習得したいですが、比率は見直してフロントエンドの学習に重きを置いていくことにします🔥,27,0,271,289,https://twitter.com/KZg1d/status/1564170477655838721,27
1564126815878541314,b4h0_c4t,2022-08-29 05:44:27+00:00,フロントエンドのテストは安易に地獄になりがちなのでちゃんと設計しなきゃダメよそして設計するためには事例を知ってなきゃダメちなみに設計したとしても運用次第ですぐダメになるのでもう何をやってもダメ,36,10,732,659,https://twitter.com/b4h0_c4t/status/1564126815878541314,46
1564099945329983489,wevillage2022,2022-08-29 03:57:41+00:00,まだJavaScriptの1%位しか触れてないのはわかるけど、CSSとか見た目を整えるよりも、こっちの学習の方が好きかも。これはフロントエンドではなく、バックエンドの方が向いているってことなのか???🤔#駆け出しエンジニアと繋がりたい #プログラミング初心者 #プログラミング初学者 #javascript #css,29,0,21,1,https://twitter.com/wevillage2022/status/1564099945329983489,29
1564069808119099392,TAMO_APP,2022-08-29 01:57:55+00:00,ヘッドレスCMSのメリット、速度とセキュリティ以外に特に感じられなかったフロントエンドはCloudFlareにおけば無料でいけるけど、ヘッドレスCMSの方はHerokuの裏技がもう使えないからコスト面ではあまりメリットがないと思う#駆け出しエンジニアと繋がりたい #プログラミング初心者と繋がりたい,13,0,35,4,https://twitter.com/TAMO_APP/status/1564069808119099392,13
1564025541636030464,pypy1225,2022-08-28 23:02:01+00:00,バックエンド専門ですが、フロントエンド奥が深すぎる！バックエンドは要件定義さえしっかりやれば作業自体は明確だけどフロントエンドは底なし沼や。#駆け出しエンジニアと繋がりたい,40,0,728,608,https://twitter.com/pypy1225/status/1564025541636030464,40
1564010005539393537,hisayuki_ik,2022-08-28 22:00:17+00:00,おはようございます。セルフハッカソン4日目フロントエンドやろうとしてたらバックエンド側のDocker環境でやりたい事が実現できなかったのでvenvでリプレイスすることにしました。本日は月曜日ですね。オフショア対応と客先営業も合わせてやっていきます。本日も頑張ってまいりましょう。,30,0,959,1018,https://twitter.com/hisayuki_ik/status/1564010005539393537,30
1564008350865838080,engineer_start,2022-08-28 21:53:43+00:00,おはようございます！「超効率的Web制作フロントエンド転職ロードマップ」、Brainにて販売開始しました。3日間限定500円で販売しております！転職を考えている方、フロントエンド学習中の方はぜひ！https://t.co/IL0D6Ov6Ak #駆け出しエンジニア #フロントエンド#Web制作 #エンジニア転職,15,2,155,359,https://twitter.com/engineer_start/status/1564008350865838080,17
1563907487480221696,webdesign0846,2022-08-28 15:12:55+00:00,明日あたりはフロントエンドについてのアウトプットの日にしようかな...🙃今日はまだまだMySQLを勉強です！！一歩づつ着実に！いつも通りBGM音量注意🥳＃Webデザイン勉強中#駆け出しエンジニアと繋がりたい https://t.co/kAshwL11Za,22,0,161,150,https://twitter.com/webdesign0846/status/1563907487480221696,22
1563782945617260544,pypy1225,2022-08-28 06:58:02+00:00,どこまでがフロントでどこからがバックエンドなのか機能の切り分けはかなり大事。ここが曖昧だと余計な実装をしてしまうので注意。チーム内で役割が分かれている場合は、積極的に振っていこう。#駆け出しエンジニアと繋がりたい,23,0,728,608,https://twitter.com/pypy1225/status/1563782945617260544,23
1563723042273955840,RoadIT_fukuda,2022-08-28 03:00:00+00:00,バックエンドの僕がフロントの実装やっていたりレイアウト決めたり‥😂たまに、自分が何者か分からなくなります！！😆でも、それもこれもスキルアップには繋がってる🔥今後、求められるスキルセットも変わってくるのでは？？,64,0,468,490,https://twitter.com/RoadIT_fukuda/status/1563723042273955840,64
1563695358768779266,frontend_fr,2022-08-28 01:10:00+00:00,今の私の現場ってフロントはNext.js/TSでバックエンドはGoでインフラはAWSなんですが、AWSのアカウントも発行してくれるわ、フロントのタスクが終われば全然バックエンド開発に携わっていいわとかでかなり神がかってる✨#駆け出しエンジニアとつながりたい #プログラミング初心者,13,0,48,0,https://twitter.com/frontend_fr/status/1563695358768779266,13
1563647618768506880,hisayuki_ik,2022-08-27 22:00:18+00:00,おはようございます。セルフハッカソン3日目です。とりあえず、RestAPI雛形が出来たのでVue（フロントエンド側）やります。本日も頑張ってまいりましょう。,11,0,959,1018,https://twitter.com/hisayuki_ik/status/1563647618768506880,11
1563514641036111881,hirofuroorg,2022-08-27 13:11:53+00:00,広島フロントエンド勉強会 Vol.30『webアニメーション勉強会（仮） with デジタルハリウッドSTUDIO広島』を開催します。日時：2022年9月20日16:00 〜 19:00（15:30 開場）場所：オンライン開催詳細はこちら https://t.co/hhBntughWR,11,3,187,155,https://twitter.com/hirofuroorg/status/1563514641036111881,14
1563467121979686913,aochuki75,2022-08-27 10:03:04+00:00,こちらはバックエンドに生クリームのリソースを使いすぎてフロントの生クリームが足りなくなってしまった旦那さんのお誕生日ケーキです https://t.co/qY2vD4WPDH,17,0,159,145,https://twitter.com/aochuki75/status/1563467121979686913,17
1563435498567536640,chocodogmagic,2022-08-27 07:57:24+00:00,やった！PHPカンファレンス沖縄で飛び入りLTさせてもらえることになった！資料用意してなかったから、社内向けに発表したのを調整して話そうかなぁ。フロントエンド目線でのWeb制作の全般的な話にする予定！,15,0,628,566,https://twitter.com/chocodogmagic/status/1563435498567536640,15
1563373690623995905,Koh22809587,2022-08-27 03:51:48+00:00,動画編集をしていると本当は自分ってこういうクリエイティブなことをやりたかったんだなぁと😆デザインは才能がないからと諦めていた時期もあったけど、趣味の写真や今やってる動画編集を通じてそう感じます！本職のエンジニアも、フロントエンドをやってみたくなってきた！#リベ大#動画編集者,11,0,55,43,https://twitter.com/Koh22809587/status/1563373690623995905,11
1563365674168500226,engineer_start,2022-08-27 03:19:57+00:00,僕は、フロントエンドのエンジニアです。初学者の頃、プログラミングスクールは費用が高かったり、それなりに学習しないとエンジニア転職できなかったり、すぐには転職が難しいと思いました。そのあたりを解消するノウハウって需要ありますかね？#フロントエンド#エンジニア転職 #web制作,12,0,155,359,https://twitter.com/engineer_start/status/1563365674168500226,12
1563335798141112322,nekosuki_mettya,2022-08-27 01:21:14+00:00,今日はSQLに手出してみる！！フロントエンドの方勉強してていつも思う「で、これの根本的なデータ管理はどうなってんの？」て疑問が晴れたらいいな#プログラミング初心者と繋がりたい#駆け出しエンジニアと繋がりたい#プログラミング初心者#webデザイン勉強中#Progate,39,1,31,12,https://twitter.com/nekosuki_mettya/status/1563335798141112322,40
1564587876305629184,mai_study_jp,2022-08-30 12:16:33+00:00,こんばんは！たった今退勤しました〜！今日はリモートでした😊夕食はプロテインにして、それを飲んだら勉強を始めます！久々にお菓子を食べたら食べ過ぎてしまい、お腹が空いていません笑取り敢えずコーヒー飲んで眠気を覚ましつつ、0時まで勉強したいと思います！良い夜活、勉強活を〜！,11,0,572,1386,https://twitter.com/mai_study_jp/status/1564587876305629184,11
1564585664217513994,chapppy0313,2022-08-30 12:07:45+00:00,本日のリモートワークのお邪魔隊。今日はなかなかハードめだったな。 https://t.co/q2ZBE1Vtwz,10,1,796,515,https://twitter.com/chapppy0313/status/1564585664217513994,11
1564585319923859458,_shinachikun,2022-08-30 12:06:23+00:00,リモートワークのデメリット。休みの日に入りたくない部屋が家の中に出来上がる。,10,0,895,236,https://twitter.com/_shinachikun/status/1564585319923859458,10
1564584438834425856,wanpi_chan,2022-08-30 12:02:53+00:00,やっとリモートできるようになりました🥹🥹🥹わーい❕ https://t.co/M8kNvIQhcG,40,0,424,432,https://twitter.com/wanpi_chan/status/1564584438834425856,40
1564582679169085440,abushajara,2022-08-30 11:55:53+00:00,弊社、原則リモートワークに完全移行に伴い定期券代支給が廃止されるってよ。実費精算が死ぬほどめんどくさい。,10,0,1199,479,https://twitter.com/abushajara/status/1564582679169085440,10
1564578388043411456,chapi_nakajitsu,2022-08-30 11:38:50+00:00,本日もお疲れ様でした！初リモートワークの感想は…お尻が痛かった💥💥💥💥以上です。,15,0,1106,945,https://twitter.com/chapi_nakajitsu/status/1564578388043411456,15
1564578185055899649,EXVvyVF3OcJpVOZ,2022-08-30 11:38:02+00:00,自分の作ったカレイの煮つけ食べながら一人でドライゼロの缶あけて飲んでたら、ふと眠くなり（最近食後はいつも眠い）うとうとしながら夫のリモート会議が終わるの待ってる夜。平和だな、桃でも剥こうかな。,11,0,401,323,https://twitter.com/EXVvyVF3OcJpVOZ/status/1564578185055899649,11
1564576232980680705,MomYuuuuui,2022-08-30 11:30:17+00:00,ノマドニア、気になりすぎるなあ。子どもと行けないかなあ。今も人口350人の離島で基本リモートワークなので、、なおさら興味津々。 #フリーランス大会議,11,0,1256,999,https://twitter.com/MomYuuuuui/status/1564576232980680705,11
1564576107579715584,0zinsei,2022-08-30 11:29:47+00:00,最近は会ったことない人同士が付き合うリモート恋愛ってものがあってだな,12,1,154,411,https://twitter.com/0zinsei/status/1564576107579715584,13
1564574815805009921,ComGrants,2022-08-30 11:24:39+00:00,ほ～ら！全てがセンセに追風！追風！✨なんかワクワクするわー！笑笑　センセは日本のおかしな古いまま見過ごされ黙認され続けとるアホなルールをブチ破る為に選ばれた人や！💥早く戦後のまま変わらないような時代にそぐわないルールを令和の時代に合うよに書き換えて欲しい！✨まずはリモートや！✊ https://t.co/ZcSd80ipJW,17,0,426,458,https://twitter.com/ComGrants/status/1564574815805009921,17
1564572936047960065,nachi_makaen,2022-08-30 11:17:10+00:00,マカえん好きの皆さんと、リモート呑み会的なのしたいなあ〜〜😆💜💜,17,0,222,246,https://twitter.com/nachi_makaen/status/1564572936047960065,17
1564572905081798656,YKNK_0111,2022-08-30 11:17:03+00:00,本日リモートで復活してみたら容赦ない感じでまたボロボロになっちった…😵‍💫😵‍💫💦営業事務って電話対応も多いからつらみo( ㅠ.ㅠ)o#ナガノスタンプ https://t.co/ticK3PAybk,10,0,506,453,https://twitter.com/YKNK_0111/status/1564572905081798656,10
1564572746671017984,Sou96358535,2022-08-30 11:16:25+00:00,今日でフォロワーさん30人？くらい増えた(o^∀^o)嬉しい～😍嬉しいので塾のリモート自習(参加自由)参加します！#いいねした人全員フォロー  します,15,0,81,515,https://twitter.com/Sou96358535/status/1564572746671017984,15
1564572390591700992,POON20415695,2022-08-30 11:15:00+00:00,＃車好き女子#バイク女子2日間・・車もバイクも乗ってない楽しみは・・食べる　🥰🤘明日も・・リモートワーク https://t.co/ZeIvzjmtrC,24,1,718,595,https://twitter.com/POON20415695/status/1564572390591700992,25
1564567172180951040,RinTsumugi,2022-08-30 10:54:16+00:00,8/30（火）こんばんは。今朝はラジオ英会話を30分聞いて、ゴミ捨てに行けた！日中は、リモートワーク。昼休みに温泉の予約を入れたり、友達と週末の約束したり。夜はワイン飲んだら何も出来ない。お酒飲まなければ、色々出来るんだろうなと思いつつ、ほろ酔い。 https://t.co/gIoRfJT9hD,16,0,61,139,https://twitter.com/RinTsumugi/status/1564567172180951040,16
1564566655887220736,yama__holic,2022-08-30 10:52:13+00:00,リモートワーク、動かなすぎなのに食べすぎちゃう😂😂😂😂明日は走るっ🏃‍♀️,21,0,1271,434,https://twitter.com/yama__holic/status/1564566655887220736,21
1564566153883635712,POON20415695,2022-08-30 10:50:13+00:00,＃車好き女子#バイク女子＃スタバリモートワーク2日目・・10時間くらいパソコンに会話してる💦 https://t.co/nQKRyLY0gO,60,4,718,595,https://twitter.com/POON20415695/status/1564566153883635712,64
1564562827536281601,raven_sakoda,2022-08-30 10:37:00+00:00,退社〜🐏🐏🐏リモート明けでマウス家に忘れてめちゃくちゃ不便だった,12,0,178,236,https://twitter.com/raven_sakoda/status/1564562827536281601,12
1564561691341271040,aWaSZ3Ovc9HQpSP,2022-08-30 10:32:30+00:00,なんかリモート対戦の準備してる人が多いから私もDiscordおとしてみようかな🐥１年前ユナイトやってたとき入れてたんだけど消しちゃった🦝,17,0,464,641,https://twitter.com/aWaSZ3Ovc9HQpSP/status/1564561691341271040,17
1564561400395051008,5wlF2,2022-08-30 10:31:20+00:00,◆ライブ情報◆Live Information◆8/30(火)21時半#うぉんたん倶楽部(LIVE)【リモート旅行】Google Earthで皆んなの地元行っちゃう⁉️何処へでも連れてっちゃうよー❤️,25,9,107,5,https://twitter.com/5wlF2/status/1564561400395051008,34
1564560939118051328,CAMP_with_BEER,2022-08-30 10:29:30+00:00,出張先のホテルでリモート会議でもホテルのWi-Fiがイマイチで音声が途切れ途切れ…😞なので今日は←飲みます🍺お疲れ様でしたー*\(^o^)/*KP🍺#KP協会#たしなむ程度協会#ビール安い#ここも何杯飲んでもキンキン凍ったグラス#わさび菜で泣きながら飲む https://t.co/tSnATlCpeI,11,1,585,658,https://twitter.com/CAMP_with_BEER/status/1564560939118051328,12
1564558202892861440,Lithium_Lilly,2022-08-30 10:18:38+00:00,リモートOKってそんだけ要求されるもの高いってことに気が付かないといけないのだよ,12,1,1257,634,https://twitter.com/Lithium_Lilly/status/1564558202892861440,13
1564567010226614272,Shirayasu3,2022-08-30 10:53:38+00:00,今日はMySQLについて勉強。vscode、linux、docker等、最初のうちはやればやるだけ覚えることが増える。それぞれの関係性を把握することを心掛け、６割程度でいいから全体把握を先に済ませることで学習効率を高めていきたい。#独学エンジニア#駆け出しエンジニアと繋がりたい,13,0,10,8,https://twitter.com/Shirayasu3/status/1564567010226614272,13
1564565127973650433,Ny_flee,2022-08-30 10:46:09+00:00,大学より資格。時間も、お金も 大学より、資格取得のために使う方が良いか。考えが甘かった。 CCNAping-t問題パケットトレーサーipアドレス計算、基数変換の練習LPIC に向けてLinuxの練習も始めました。Linux 楽しい。#駆け出しエンジニア,26,0,410,653,https://twitter.com/Ny_flee/status/1564565127973650433,26
1564538422424784896,suzuki_py,2022-08-30 09:00:02+00:00,Qiitaで #Linux に関する投稿を定期的に漁ってます！#プログラミング#プログラミング初心者#駆け出しエンジニアと繋がりたい【ホームディレクトリ】「~（チルダ）」って何ですか？https://t.co/mgZIFgMGfS,17,0,495,307,https://twitter.com/suzuki_py/status/1564538422424784896,17
1564530514492805121,Azusa468_Linux,2022-08-30 08:28:36+00:00,チューバータウンで竹林人間氏のアカウント発見www https://t.co/Y6niGGByzp,38,1,442,658,https://twitter.com/Azusa468_Linux/status/1564530514492805121,39
1564527697497231360,TQrs0,2022-08-30 08:17:25+00:00,"8月27日学習報告・300記事ノック5本・過去動画 【Network】クラウドについて 1本・e-typing4回 A-A-B+A-・Envader Linux基礎4,5学習報告を書くのが面倒になってきたので自動化するか。#RareTECH 64日目#駆け出しエンジニアと繋がりたい #希少型エンジニア を目指して#プログラミング勉強中",11,0,31,0,https://twitter.com/TQrs0/status/1564527697497231360,11
1564512207039131648,teramako,2022-08-30 07:15:52+00:00,やっべー。マジで rm -rf / した人が発生した。(Linuxじゃないので--preserve-rootオプションなし),32,18,1198,667,https://twitter.com/teramako/status/1564512207039131648,50
1564449132885921793,envader_plus,2022-08-30 03:05:13+00:00,Linuxコマンド（touch）の紹介記事です👾ぜひ読んでください👾#プログラミング初心者#駆け出しエンジニアと繋がりたい https://t.co/dbOXXYYOgf,15,0,1301,4,https://twitter.com/envader_plus/status/1564449132885921793,15
1564387427732492290,kakedashiman1,2022-08-29 23:00:02+00:00,【2022-08-29の閲覧ランキング 第1位】　記事タイトル：【コピペOK】Linuxでコマンドを同時実行(並列実行)する手順　▼▼詳しくはこちら▼▼　https://t.co/tQ2He3KQCI　#ブログ　#Progate　#駆け出しエンジニアと繋がりたい,10,0,1421,271,https://twitter.com/kakedashiman1/status/1564387427732492290,10
1564375590907650049,openyellowos,2022-08-29 22:13:00+00:00,開発をサポートしている「お〜げさん」がSurface３上で作品？を作りました。デバイス：Surface３アプリ：Blender（レンダリングまで全て）作品名：　おデザイナーの饅頭くんがSurfaceのイメージ画像を制作してくれました。#Linux #open_Yellow_os #b3d #blender https://t.co/QOTc8YQ7nE,21,3,416,2,https://twitter.com/openyellowos/status/1564375590907650049,24
1564253863301255168,aumy_f,2022-08-29 14:09:18+00:00,絵の無断転載を禁止するシステムが開発されるとLinuxから見れない絵という概念が絶対登場する,51,8,446,359,https://twitter.com/aumy_f/status/1564253863301255168,59
1564231748820807680,miyoi_cos,2022-08-29 12:41:25+00:00,いいですかLinux系OSのUbuntu Studioですが、Adobe Photoshopと同等クラスのGIMPやOBS等クリエイター向けのLinux OSなのは良い❗️一度どうてしょう❓️#コスプレ#コスプレ初心者#コスプレイヤーさんと繋がりたい https://t.co/qyAIJvbIq7,33,4,602,318,https://twitter.com/miyoi_cos/status/1564231748820807680,37
1564207151207575552,drib__,2022-08-29 11:03:41+00:00,Linux Subsystem for FreeBSDのキャラクター好きすぎるhttps://t.co/sEwt3xmHqz,13,8,736,666,https://twitter.com/drib__/status/1564207151207575552,21
1564194125154463744,pcfreedomplus1,2022-08-29 10:11:55+00:00,ハードウェアにもっと明るかったらこんなの開発したいよね。https://t.co/bXwQ927Hbi,14,5,1899,1471,https://twitter.com/pcfreedomplus1/status/1564194125154463744,19
1564186076645711872,openyellowos,2022-08-29 09:39:56+00:00,open.Yellow.osのデスクトップをChromeOS風にカスタマイズしてみました！ChromeブラウザのWEBアプリ化を使って　Youtube・Twitter　をアプリとして起動しています。#Linux #open_Yellow_os https://t.co/CCbCUB2vyi,37,9,416,2,https://twitter.com/openyellowos/status/1564186076645711872,46
1564168409947877376,mromro_U,2022-08-29 08:29:44+00:00,これは脅迫されてLinuxを無理やり使いざるを得ない状況に陥ったある日の僕 https://t.co/7Op4UVB2as,16,1,185,243,https://twitter.com/mromro_U/status/1564168409947877376,17
1564152784085143553,Arumakan_ei1727,2022-08-29 07:27:38+00:00,高校の修学旅行のとき、新幹線の中で Linux のインストールしてた,11,0,724,740,https://twitter.com/Arumakan_ei1727/status/1564152784085143553,11
1564130673316995072,yurina256,2022-08-29 05:59:47+00:00,酒←のめない女装←似合わないLinux←得意じゃない,14,0,591,705,https://twitter.com/yurina256/status/1564130673316995072,14
1564126897151557633,ten_forward,2022-08-29 05:44:47+00:00,9/11 #技術書典 13 オフラインイベントに参加します。当日は在庫なしで見本誌だけ置くつもりなので、コンビニ印刷で見本誌を自作してみた。なんちゃって無線綴じ、なんとなくうまく行ってる感じです（すぐバラけそうww）Linuxコンテナの本を出します #lxcjp https://t.co/SMSsFZHSTq,17,3,1429,1177,https://twitter.com/ten_forward/status/1564126897151557633,20
1564115835069014016,KudryavkaCrouka,2022-08-29 05:00:49+00:00,今日は病院へ行く為に有給使ってお仕事おやすみ〜。んで、病院に行く前にここ2週間程つまずいているCubicSDRへMSi.SDRの組み込み再挑戦し、ようやく成功です〜。結局、MSi.SDR関係をLinuxのブラックリストに登録したらCubicSDRで認識できるようになりました〜。長かったのです〜。(´；ω；｀) https://t.co/nONilCfU58,10,0,514,680,https://twitter.com/KudryavkaCrouka/status/1564115835069014016,10
1564115601101971456,OP_MORI,2022-08-29 04:59:53+00:00,LinuxとWindowsの違いとは？どちらに詳しいほうがいいのかhttps://t.co/Owe9rpR9kl,12,0,912,913,https://twitter.com/OP_MORI/status/1564115601101971456,12
1564092798759882752,emiko_iret,2022-08-29 03:29:17+00:00,お問い合わせいただきましたのでリプに弊社の求人一覧載せておきます💁‍♀️職種毎に必須スキルも異なるので是非参考に😊#転職#AWS#GoogleCloud#プログラミング#駆け出しエンジニアと繋がりたい#エンジニア#クラウド#Python #PHP #Linux,26,1,139,171,https://twitter.com/emiko_iret/status/1564092798759882752,27
1564092287369457664,yoshivesmovie,2022-08-29 03:27:15+00:00,LINUX中華ゲーム機新時代来るぞ・・・！！！『ODROID GO ULTRA』発表！ https://t.co/308kUhG10h,32,7,489,369,https://twitter.com/yoshivesmovie/status/1564092287369457664,39
1564086743103463424,envader_plus,2022-08-29 03:05:13+00:00,Linuxコマンド（sudo）の紹介記事です👾ぜひ読んでください👾#プログラミング初心者#駆け出しエンジニアと繋がりたい https://t.co/07UOnL2N1A,21,0,1301,4,https://twitter.com/envader_plus/status/1564086743103463424,21
1564072552070533122,old_pgmrs_will,2022-08-29 02:08:50+00:00,FlutterFlow：ローコードでFlutterベースのプロジェクト作成→native app開発ツール。mobileだけでなくMac/Win/Linuxアプリも作成可能。言語はDart、バックエンドがFirebaseなら色々捗ります。push通知や決済連携など各種サービス連携もOK#駆け出しエンジニアと繋がりたい https://t.co/khPvnKDIkh,14,0,593,580,https://twitter.com/old_pgmrs_will/status/1564072552070533122,14
