1557935602833637376,wkwkdkdk_psi,2022-08-12 03:42:47+00:00,Hello World!!今日のpickup記事はこちら!※これは定期tweetですhttps://t.co/0ACwboyfuP#blog #ブログ #ブログ初心者 #ブログ仲間 #ブログ仲間募集#python #自動化,10,1,203,252,https://twitter.com/wkwkdkdk_psi/status/1557935602833637376,11
1557933266396925954,navigator_marke,2022-08-12 03:33:30+00:00,自分でコーディング。第6章シーザー暗号総当たり攻撃。caesar cipher(brute force)#Pythonでいかにして暗号を破るか#python#駆け出しエンジニアと繋がりたい https://t.co/Kfx8wK6VRk https://t.co/oopU6lNB9P,10,0,42,20,https://twitter.com/navigator_marke/status/1557933266396925954,10
1557930677626355712,yu__python,2022-08-12 03:23:13+00:00,@mossanpower もっさん！こんにちは！今日も置きリプさせて頂きます！,19,0,703,210,https://twitter.com/yu__python/status/1557930677626355712,19
1557925590891728898,FX180507,2022-08-12 03:03:00+00:00,EAのバックテスト結果をExcelやPythonなどで詳細分析するときCSVファイルで受け渡しをするわけですが、これを効率よくするために「MT5でバックテストと同時に結果をCSV出力する方法」をまとめましたコピペしやすいように書いたのでよかったら活用してみて下さい https://t.co/CYZoZ6lvI7 #Qiita,48,4,1796,253,https://twitter.com/FX180507/status/1557925590891728898,52
1557924840665149440,suzuki_py,2022-08-12 03:00:01+00:00,Qiitaで初心者向けの投稿を定期的に漁ってます！#プログラミング#プログラミング初心者#駆け出しエンジニアと繋がりたい【超個人的】python初学者向けエラー対応のPDCAサイクルhttps://t.co/Jeay1LNiij,15,0,494,311,https://twitter.com/suzuki_py/status/1557924840665149440,15
1557924108855169025,tantan_python,2022-08-12 02:57:07+00:00,cinnamon ghost♂最近ゴースト熱が上がってる夏レプで見させてもらったゾンビパイが強烈だったなぁ https://t.co/p3ZuFFiCv8,40,1,1441,1351,https://twitter.com/tantan_python/status/1557924108855169025,41
1557923653773578240,kitao,2022-08-12 02:55:18+00:00,"Though there’s no fancy image, now Emscripten version of Pyxel can be imported on web browsers. Just a little more!面白い絵はないですが、Emscripten版のPyxelをブラウザ上でインポートできるようになりました。あともう少し！#pyxel #python #gamedevhttps://t.co/kQjZxGQNjV https://t.co/mWQgjZ6kVS",13,6,1103,146,https://twitter.com/kitao/status/1557923653773578240,19
1557920531395264513,hachi_python,2022-08-12 02:42:54+00:00,ココナラで継続案件を獲得する方法✅納期より早く終わらせる✅試作品でいいから渡す✅要望を聞いて上げるお客様ファーストの精神が大事これを意識するだけで継続案件が来やすくなりました#駆け出しエンジニアと繋がりたい,12,0,839,128,https://twitter.com/hachi_python/status/1557920531395264513,12
1557908897637478400,NGY_it_anken,2022-08-12 01:56:40+00:00,8/12【Instagram更新】随時最新の案件情報を掲載しています💁‍♀️是非ご覧ください！https://t.co/7yOYLR6vis#Java #Python #C言語 #AWS #リモート #在宅ワーク #転職 #エンジニア転職 #駆け出しエンジニアと繋がりたい #企業公式相互フォロー #企業公式夏のフォロー祭り#SES営業#Twitter転職,15,2,572,581,https://twitter.com/NGY_it_anken/status/1557908897637478400,17
1557906710232068097,tantan_python,2022-08-12 01:47:58+00:00,ココのオレンジのシミドックスが良い https://t.co/VDFBvixr2Y https://t.co/OOYlffgPk1,18,0,1441,1351,https://twitter.com/tantan_python/status/1557906710232068097,18
1557895459653681152,hachi_python,2022-08-12 01:03:16+00:00,requestsライブラリのgetメソッドのレスポンスが403だった場合サーバーからリクエストをブロックされていますそんなときに回避する方法ユーザーエージェントを設定するアクセス間隔を1分以上空けるIPアドレスを変更するこれらを試してみましょう#駆け出しエンジニアと繋がりたい,14,0,839,128,https://twitter.com/hachi_python/status/1557895459653681152,14
1557894640363139072,griddb_jp,2022-08-12 01:00:01+00:00,#機械学習、#Python、#GridDB を用いて通信事業者の解約率を予測する https://t.co/AYOupKXJwQ #Qiita #opensource #oss #kaggle #machinelearning #ml#オープンソース #駆け出しエンジニアとつながりたい #駆け出しエンジニアと繋がりたい,19,3,1898,1560,https://twitter.com/griddb_jp/status/1557894640363139072,22
1557876473624940545,na___Python,2022-08-11 23:47:49+00:00,今日でぴったり60日🥰安心しました😮‍💨初めての繁殖経験で色々試してみましたがこのまま上手くいけばいいなあ😮‍💨😮‍💨‼︎ https://t.co/zI5SF0lc63,32,0,267,273,https://twitter.com/na___Python/status/1557876473624940545,32
1557873733049925632,VJbAhY23aDwLmJ1,2022-08-11 23:36:56+00:00,おはようございます。今日も朝活終了して今から仕事です^ ^今日は寝坊して少ししか出来なかったな💦最近qittaの使い方も分かってきたので色々と文章書く練習として使ってみたいと思います😭でも、PHPやらPythonやらどれを最初に勉強にしていいのか分からない😭,10,0,63,132,https://twitter.com/VJbAhY23aDwLmJ1/status/1557873733049925632,10
1557856895922163712,y__hayashi,2022-08-11 22:30:02+00:00,シェルを実行！待っていれば欲しい環境が目の前に https://t.co/ucQNXnOUmk#buildree #php #Laravel #fuelphp #フレームワーク #apache #nginx #エンジニア #python #go #nodejs #プログラミング学習 #プログラミング初心者,12,3,182,70,https://twitter.com/y__hayashi/status/1557856895922163712,15
1557854862595203072,Hh5Xm8,2022-08-11 22:21:57+00:00,8/12(Fri)・基本情報技術者・PythonFEの午後問題に挫折しそうです💀いっかい午前に戻ります。#駆け出しエンジニアと繋がりたい #プログラミング初心者と繋がりたい #プログラミング,43,2,220,154,https://twitter.com/Hh5Xm8/status/1557854862595203072,45
1557846275927601152,std0606,2022-08-11 21:47:50+00:00,2次元リストね、OK！【paizaラーニング】Python3入門編「2次元リストを作成する」の演習課題に見事正解！現在のジョブは「伝説の剣士」です！ https://t.co/Qpvcq6jyDK #paiza #プログラミング初心者  #プログラミング初心者と繋がりたい #プログラミング勉強中 #Python,12,0,16,8,https://twitter.com/std0606/status/1557846275927601152,12
1557836723702611968,yu__python,2022-08-11 21:09:52+00:00,@mossanpower もっさん！おはようございます！☀️お盆休みでも置きリプさせて頂きます！！,29,0,703,210,https://twitter.com/yu__python/status/1557836723702611968,29
1557836536166907904,oxUWhmhcEYMG6zj,2022-08-11 21:09:08+00:00,おはようです☀Python勉強でimport、モジュールがわからない💧泣画像ファイルを読み込みの勉強してるんだけど、、、ライブラリのインストールって？？ファイルダイナログって？？必ず乗り切って前に進んでやる🏃‍♀️💪 #プログラミング初心者 #Python初心者 #プログラミング初心者と繋がりたい,22,0,1400,2725,https://twitter.com/oxUWhmhcEYMG6zj/status/1557836536166907904,22
1557835455491895296,yu__python,2022-08-11 21:04:50+00:00,@afilasite アフィラさん！おはようジャパァーーン！！本業以外の収入稼げた時の感覚、忘れられません😆今日もやったります！🔥,10,0,703,210,https://twitter.com/yu__python/status/1557835455491895296,10
1557833495720112128,yu__python,2022-08-11 20:57:03+00:00,大学入学して早々、自信を無くした。高校時代、塾の誰よりも出来た数学と物理。大学では「駿台模試トップ100」や「数学・物理センター満点」がゴロゴロいた。でもスキルをつけ始めてから、実力がつき少しずつ自信が持てる様になった。自己投資して本当によかった。,12,2,703,210,https://twitter.com/yu__python/status/1557833495720112128,14
1557828500106760193,MS08170,2022-08-11 20:37:12+00:00,修論の謝辞には教授たちや家族に加え、愛機surface laptopをいれたい。大学に応募した時のPersonal statementはsurfaceで書いたし、留学中はほぼ毎日一緒にいた。pythonやRでどれだけエラーを出しても頑張ってくれたし、QGISで夜通し作業させても結果を残してくれた。この１年間の大切な相棒ですね。,54,0,1649,896,https://twitter.com/MS08170/status/1557828500106760193,54
1557800755968454656,noritada,2022-08-11 18:46:57+00:00,インストールまわりは初心者がつまづきやすいし、環境に依存するものを人がフォローするのは骨が折れるし、色々な環境に対応できるようドキュメントを書くのも大変なので、システム的な支援は大切「Python」のVS Code拡張機能が強化、チュートリアルでインストールまで支援https://t.co/5z90Ul9uU3,40,13,379,512,https://twitter.com/noritada/status/1557800755968454656,53
1557789762676994049,hachi_python,2022-08-11 18:03:16+00:00,プログラミング未経験から副業で稼ぐならスクレイピングがおすすめ案件もそれなりにあり、そこまで難しくありません。スクレイピング案件をやれば必然的に会社でも使えるスキルが身に付きます。#駆け出しエンジニアと繋がりたい,20,0,839,128,https://twitter.com/hachi_python/status/1557789762676994049,20
1557774800843866112,hanzawa108,2022-08-11 17:03:49+00:00,~動画編集ソフト開発進捗~BGM挿入機能実装サウンドファイルの音声波形をサムネイル化#動画編集者と繋がりたい #動画編集 #プログラミング #プログラマー #Python https://t.co/dWzlcEL0aK,15,0,200,188,https://twitter.com/hanzawa108/status/1557774800843866112,15
1557761987282477056,hachi_python,2022-08-11 16:12:54+00:00,プログラミングで稼ぐ方法は主に以下がありますが、✅副業エージェント✅クラウドソーシング✅転職私はクラウドソーシングのココナラがおすすめします。理由は営業をせずに副業収入として稼げるので楽だからです。#駆け出しエンジニアと繋がりたい,17,0,839,128,https://twitter.com/hachi_python/status/1557761987282477056,17
1557760378108801024,null_0124,2022-08-11 16:06:30+00:00,競プロコンテストの問題文の言語が知りたくて「What languages are available in the contest?」を開いたら「C/C++/Java/Python」って書いてあった そう...,12,0,1266,1944,https://twitter.com/null_0124/status/1557760378108801024,12
1557751918445080577,chima_happy5,2022-08-11 15:32:53+00:00,今日は英語とPython.英語は単語とTOEIC。Kaggle本でディープラーニングに少し触れてみた。いろいろと新しいものが学べて楽しい,13,0,878,175,https://twitter.com/chima_happy5/status/1557751918445080577,13
1557943761510211584,anju_puroboys,2022-08-12 04:15:12+00:00,夏フェスや夏ライブに‼️ピューロボーイズ、ピューロボーイズはいかがですか〜‼️✅歌って踊れるキラキラアイドル✅KAWAII✅喋れる✅KAWAII✅YouTube5万再生、TikTok計1万k再生突破✅俳優、声優、元エンジニア、元警察官と訳あってアイドル揃い夏ライブ是非よんでください😭いつでも今すぐ https://t.co/Kr9Yialksk,15,9,623,106,https://twitter.com/anju_puroboys/status/1557943761510211584,24
1557941704333729793,JOPS_JP,2022-08-12 04:07:02+00:00,お昼休みに「キツネリスになりたい」ってつぶやいたら、長身エンジニアが「ロボット兵」をやってくれたんだジョ🤖さぁ、#あと半日 がんばるんだジョ💪#金曜ロードショー#ラピュタ#ロボット兵#企業公式夏のフォロー祭り#企業公式夏の相互フォロー祭り#がんばろう企業公式#企業公式つぶやき部 https://t.co/rsXSja0UDS,15,0,420,428,https://twitter.com/JOPS_JP/status/1557941704333729793,15
1557940908355887104,EGW4qILhTvJbaUW,2022-08-12 04:03:52+00:00,THE ANSWERさんに取材していただきました！異例 Jのエース→ITエンジニアに#Yahooニュースhttps://t.co/d57V6DGff7#セカンドキャリア#アスリート#コラボスタイル#IT#サッカー選手,111,31,1873,277,https://twitter.com/EGW4qILhTvJbaUW/status/1557940908355887104,142
1557940239569924098,marinarock_hmhm,2022-08-12 04:01:12+00:00,昨日はレコーディングでした🎶全曲！歌い切ったぞー(๑•̀ㅂ•́)و✧エンジニアのTeruさんが立ち上がったところパシャリ😎📸とってもお世話になってます！新曲出来上がりお楽しみに✨最速で聴けるのは8/20‼️予約まだまだ受付中🎉✨ｷﾃﾈ！https://t.co/bYfp7e9XsP#スタブリ https://t.co/DxpVJ8NyRV,20,3,1420,1046,https://twitter.com/marinarock_hmhm/status/1557940239569924098,23
1557933974365753345,Yurie_dev,2022-08-12 03:36:19+00:00,◆ タイピングが遅い話私はタイピング早くないし、打ち間違いもしょっちゅうします。早いに越したことはないけど、イチから全文タイプする必要はないので、遅くても大丈夫。Emmetに頼りっぱなし😙#web制作 #プログラミング初心者 #駆け出しエンジニアと繋がりたい #エンジニア,20,0,94,4,https://twitter.com/Yurie_dev/status/1557933974365753345,20
1557933236072095744,collabo_style,2022-08-12 03:33:23+00:00,THE ANSWERさまに、元Jリーガーで現在弊社で開発をしている内村のセカンドキャリアについてインタビューをしていただきました。セカンドキャリアを切り拓く姿をぜひご覧ください！引退→ITエンジニア転職は「逆に面白い」　J1札幌元エース、今歩む前例なき第二の人生https://t.co/LV85kucLVT,98,52,160,62,https://twitter.com/collabo_style/status/1557933236072095744,150
1557931956733870080,divrots,2022-08-12 03:28:18+00:00,"「エンジニアは業後や土日にもコード書いたり勉強""しないといけない""」と大変な職種のような表現もあるが、営業だって本読んだり勉強したり、街歩いてて見た広告など常に学んだりする、というかしてたけどなぁ。広告営業時代は特に。""仕事(目的)に紐づく思考と行動""を常に意識するのは職種に関係ない🥷",53,11,206,136,https://twitter.com/divrots/status/1557931956733870080,64
1557929523563610112,laperean_noir,2022-08-12 03:18:38+00:00,ミス・サイゴン  08.12  matineeマチネはこちらへ。今期はこの1回のみです！昆ちゃんとお久しぶりのチョ・サンウンさんの組み合わせ。そして、レジェンド市村エンジニア✨それぞれの生き様見届けて来ます！超良席だから、ワクワク😊 マエストロは若林さん。幕が上がる奇跡に感謝して。#ミスサイゴン https://t.co/CjKnbZhBB9,59,0,933,2006,https://twitter.com/laperean_noir/status/1557929523563610112,59
1557929127155445760,pypy1225,2022-08-12 03:17:03+00:00,今楽してる大学生へ。夏休み、何の目標もない大学生。社会人エンジニアおじさんからアドバイスだ。この夏休み、一か月だけでいいから自分のキャリアを真剣に考え、そのトレーニングを積もう。営業でもITでも何でもいい。脳死で過ごすその時間、いつか必ず後悔する。#駆け出しエンジニアと繋がりたい,11,0,593,597,https://twitter.com/pypy1225/status/1557929127155445760,11
1557927378130653184,puni_puny,2022-08-12 03:10:06+00:00,聞いて。アメリカでは履歴書なしで選考をして内定を出す会社がある。デザイナーやエンジニアなど技術者向けの求人に多い。バックボーンは気にせず求められる技術があるかどうかで判断されるのは基準がわかりやすく、納得しやすい。日本の文化だと導入のハードルはあるけれど、今後変わってくるのかも,10,0,199,99,https://twitter.com/puni_puny/status/1557927378130653184,10
1557925246149459968,yucatio,2022-08-12 03:01:38+00:00,私が思う駆け出し・一人前・つよつよエンジニア駆け出しエンジニア: 言語とフレームワークの入門書を一通り理解している一人前エンジニア: 仕事上使うツールを使いこなせるつよつよエンジニア: 仕事で使わないツールもたくさん知っている#駆け出しエンジニアと繋がりたい,26,0,163,149,https://twitter.com/yucatio/status/1557925246149459968,26
1557924478792769537,izumin21504115,2022-08-12 02:58:35+00:00,事業会社だとエンジニアの適性が無いと判断された段階で品証とか営業とか別部門に配置転換されるからクビにはならないし、そこで活躍する人もいるのでいいと思うんだけど、クレクレ君とは言え自分を慕ってくる若者にエンジニアとして死刑宣告するのは結構しんどいですよ。 https://t.co/3zmOWfwpKN,13,2,1260,784,https://twitter.com/izumin21504115/status/1557924478792769537,15
1557921957232132097,consapanman,2022-08-12 02:48:34+00:00,うううううううっちーがヤフートップにいる🥰😇👺♥️異例 Jのエース→ITエンジニアに 2022年8月12日 https://t.co/QHFOQylAzU,12,1,886,476,https://twitter.com/consapanman/status/1557921957232132097,13
1557921144120160257,satoryo0929,2022-08-12 02:45:20+00:00,引退→ITエンジニア転職は「逆に面白い」　J1札幌元エース、今歩む前例なき第二の人生（THE ANSWER） https://t.co/GESxDHk6cI,12,4,901,643,https://twitter.com/satoryo0929/status/1557921144120160257,16
1557915480652152834,haruuudaigaku,2022-08-12 02:22:49+00:00,エンジニアってなんでこう勉強熱心な方が多いんだろう。わたしもそうだけどきっと勉強してるって感覚なく学んでるんやね。学びに終わり見えないから超楽しいんやけど。＃駆け出しエンジニアと繋がりたい#インフラエンジニア#新卒SE,73,0,232,180,https://twitter.com/haruuudaigaku/status/1557915480652152834,73
1557914959455010816,MFN510,2022-08-12 02:20:45+00:00,エンジニアって、何ができたらエンジニアなんだろうねぇ。自分は絶対にエンジニアではないという自覚はあるんだけど。,10,0,261,51,https://twitter.com/MFN510/status/1557914959455010816,10
1557912532723331072,Sasaharacyaho,2022-08-12 02:11:07+00:00,え？今夜は全国一斉サーバー負荷耐久テストでエンジニアお盆休み返上夜勤の日じゃないんですか？#天空の城ラピュタ #バルス,11,0,1333,1275,https://twitter.com/Sasaharacyaho/status/1557912532723331072,11
1557910982382325761,Take_san_yade,2022-08-12 02:04:57+00:00,ITパスポート取得への道😈5日目また寝落ち...やべーな、そろそろ気合い入れよ🥺#ITパスポート #エンジニア #駆け出しエンジニアと繋がりたい #初心者エンジニアと繋がりたい,15,0,73,40,https://twitter.com/Take_san_yade/status/1557910982382325761,15
1557910944361377792,itarumusic,2022-08-12 02:04:48+00:00,"theLetter はフロントの一人目リードエンジニアを募集中です🔥・社員数のわりにトラフィックすごい・これからフロントの導入なりなんなり本格化する・アーリーステージという、稀有な環境だと思います。副業スタートも歓迎です（DM, メール喜んで）！＾＾https://t.co/VX9L1Ffuk7 https://t.co/9oobvDxZIB",10,2,1043,454,https://twitter.com/itarumusic/status/1557910944361377792,12
1557910425802784768,kobayashiryuji,2022-08-12 02:02:44+00:00,【お道具箱.com】初心者のエンジニアとデザイナーは必見です！イラストサイトや普段使うHTMLとCSSがまとめられたサイトです。かなりの時短になります！！是非使ってください☆https://t.co/H6Gnf4OT1T#駆け出しエンジニアと繋がりたい #駆け出しwebデザイナーと繋がりたい #webデザイン勉強中,11,0,48,58,https://twitter.com/kobayashiryuji/status/1557910425802784768,11
1557894640363139072,griddb_jp,2022-08-12 01:00:01+00:00,#機械学習、#Python、#GridDB を用いて通信事業者の解約率を予測する https://t.co/AYOupKXJwQ #Qiita #opensource #oss #kaggle #machinelearning #ml#オープンソース #駆け出しエンジニアとつながりたい #駆け出しエンジニアと繋がりたい,19,3,1898,1560,https://twitter.com/griddb_jp/status/1557894640363139072,22
1557713446778441728,aoi_studyai,2022-08-11 13:00:01+00:00,👇今日の気になるAIニュース【保存版】オープンデータ・データセット100選  -膨大なデータを活用しよう！ https://t.co/6AbcpTU8xr 画像・テキスト・音声など、大量のデータセットがまとめられています。ぜひご活用ください📚✨#AI #人工知能 #機械学習 #駆け出しエンジニアと繋がりたい,18,1,1865,1353,https://twitter.com/aoi_studyai/status/1557713446778441728,19
1557683243599659014,yoko_materialDX,2022-08-11 11:00:00+00:00,#機械学習 により相転移予測の論文。無機材料の相転移はエネルギー的に沢山の局所解が存在し、複雑で予測が難しい。相転移に重要な歪みモードを記述子に使用することで、効率的に学習でき、実構造の予測に成功したそうです。やっぱり材料科学ではドメイン知識が大切。https://t.co/uA2vzxa8uL,14,3,1356,538,https://twitter.com/yoko_materialDX/status/1557683243599659014,17
1557585046969626624,ssohsn,2022-08-11 04:29:48+00:00,うちの子のイラストを『AI』に描いてもらうやつ！精度めっちゃ良くなったどこからどう見ても茉礼くんですね！！！こちらどう見てものほしおさんの絵にしか見えませんがAIが描いたものです😘#ichistar#機械学習 https://t.co/YwegZG99SV https://t.co/g0nAsaVLgY,14,7,831,282,https://twitter.com/ssohsn/status/1557585046969626624,21
1557543069741748224,AxrossRecipe_SB,2022-08-11 01:43:00+00:00,"レシピ数、370個を突破しました🎉🥳現場エンジニアのノウハウをもとにした実践教材 ""レシピ""をもとに、PythonによるAI/機械学習の実装やデータ分析を追体験できます👩‍💻🧑‍💻https://t.co/4PAeVlQ2u5#AxrossRecipe#機械学習 #Python #データ#プログラミング学習#駆け出しエンジニアと繋がりたい https://t.co/SixVa3Gal5",15,2,1058,83,https://twitter.com/AxrossRecipe_SB/status/1557543069741748224,17
1557532250425610241,griddb_jp,2022-08-11 01:00:00+00:00,#Python と #GridDB を用いて住宅データの #線形回帰モデル を構築する https://t.co/IfhkhJYzLB #Qiita #OpenSource #OSS #DataScience #BigData #MachineLearning #ML #DataAnalytics  #オープンソース #機械学習 #駆け出しエンジニアとつながりたい #駆け出しエンジニアと繋がりたい,23,6,1898,1560,https://twitter.com/griddb_jp/status/1557532250425610241,29
1557321176027844608,TomoCodeHQ,2022-08-10 11:01:16+00:00,ベイズ推定とは、ベイズの定理を用いて、より多くのデータや証拠が集まるにつれて、仮説の確率を更新していく統計的推論の手法です。#ベイズ #機械学習 #統計 https://t.co/URBMbAT1eC,12,1,1233,836,https://twitter.com/TomoCodeHQ/status/1557321176027844608,13
1557257808001007616,KMoco0109,2022-08-10 06:49:28+00:00,データを減らすのがアンダーサンプリング、列(次元)を減らすのが次元削減！？でいいよね？？#機械学習 #駆け出しエンジニアと繋がりたい,34,0,72,46,https://twitter.com/KMoco0109/status/1557257808001007616,34
1557254500096053248,selfdevelop2019,2022-08-10 06:36:19+00:00,ブログ連続更新852日#ブログ #プログラミング勉強中  #プログラマー #機械学習 #スクレイピング #Python #プログラミング #PHP #Ubuntu #仮想通貨 #メタバース #プログラミング独学 https://t.co/FZMcWtcZwP,15,2,138,0,https://twitter.com/selfdevelop2019/status/1557254500096053248,17
1557245358580805633,griddb_jp,2022-08-10 06:00:00+00:00,PythonとGridDBを用いたLDAによるトピックモデリング https://t.co/d9JZrsr382 #Qiita #OpenSource #OSS #DataScience #BigData #Python #Programming #MachineLearning #ML #DataAnalytics  #GridDB#オープンソース #機械学習 #駆け出しエンジニアとつながりたい #駆け出しエンジニアと繋がりたい,13,1,1898,1560,https://twitter.com/griddb_jp/status/1557245358580805633,14
1557179280232415232,tbtech_,2022-08-10 01:37:26+00:00,システムエンジニアからのおすすめ本!!「Pythonではじめる機械学習 ―scikit-learnで学ぶ特徴量エンジニアリングと機械学習の基礎」初めて機械学習にふれた本2017年で内容的に古いかもしれませんが、とても勉強になりました！https://t.co/mOjZ1guuSk#機械学習 #python #企業公式相互フォロー,11,1,104,116,https://twitter.com/tbtech_/status/1557179280232415232,12
1557168098897285121,griddb_jp,2022-08-10 00:53:00+00:00,PythonとGridDBを用いた自然言語処理とトピックモデリング：https://t.co/YAgu8iXlY0 #OpenSource #OSS #DataScience #BigData #Python #Programming #MachineLearning #ML #DataAnalytics  #GridDB#オープンソース #機械学習 #駆け出しエンジニアとつながりたい #駆け出しエンジニアと繋がりたい,27,5,1898,1560,https://twitter.com/griddb_jp/status/1557168098897285121,32
1557155406073708544,HacarusInc,2022-08-10 00:02:34+00:00,【イベントレポート】 8/7に開催されたJAWS-UG京都 のイベントレポートです。ハカルスからはデータサイエンティストの宇佐見 @USAvich_1p とアプリケーションエンジニアの内野 @ucn_hiro が登壇しました🎤 #エンジニア  #jawsug #AI #機械学習 https://t.co/aH8VtMlKb7,19,4,548,41,https://twitter.com/HacarusInc/status/1557155406073708544,23
1556958475187392513,dsmatome_,2022-08-09 11:00:02+00:00,"新着記事｜【2022年版データサイエンスの学び方】""データサイエンスを学ぶのに最適な方法は何か？""今回の記事では海外で有名な学習プラットフォーム「Dataquest」の創始者がその答えを語っています👀#データサイエンス#機械学習#AIhttps://t.co/HfvLz3kFBM",14,2,27,1,https://twitter.com/dsmatome_/status/1556958475187392513,16
1556934869443579904,sooz32904010,2022-08-09 09:26:13+00:00,新しい記事を公開しました。こないだブログに初コメントいただいて、モチベーション上がりました。反応って大事ですね。#AI #機械学習 #プログラミング #駆け出しエンジニアと繋がりたい #ブログ仲間と繋がりたいhttps://t.co/xksaGgTWi1,14,0,491,545,https://twitter.com/sooz32904010/status/1556934869443579904,14
1556928275447877632,suzuki_py,2022-08-09 09:00:01+00:00,Qiitaで #機械学習 に関する投稿を定期的に漁ってます！#プログラミング#プログラミング初心者#駆け出しエンジニアと繋がりたい【強化学習】AlphaZeroを解説・実装https://t.co/oZI3LxB6IV,13,0,494,311,https://twitter.com/suzuki_py/status/1556928275447877632,13
1556924563614601216,_uuai_,2022-08-09 08:45:16+00:00,今日初めて社内で、機械学習とLightGBMという単語を見ました😳#機械学習,20,1,191,125,https://twitter.com/_uuai_/status/1556924563614601216,21
1556913968022978560,ssohsn,2022-08-09 08:03:10+00:00,AIにうちの子のイラストを描かせる方法の備忘録ですhttps://t.co/PukoZbeMvf#機械学習#うちの子　#ichistar,19,14,831,282,https://twitter.com/ssohsn/status/1556913968022978560,33
1556882260389171200,KMoco0109,2022-08-09 05:57:11+00:00,機械学習に釣られ購入…表情豊かなキャラクターたちが楽しめます！1024次元という超多次元をどう工夫して尾田栄一郎らしさを学習させたのか？（対談話あり）#onepiece #機械学習 #駆け出しエンジニアと繋がりたい ONE PIECE ALL FACES 2 [ 尾田 栄一郎 ] [楽天] https://t.co/UQ4qdxu0kU #rakuafl https://t.co/DGxwE5RUq6,13,0,72,46,https://twitter.com/KMoco0109/status/1556882260389171200,13
1556665135099326464,ssohsn,2022-08-08 15:34:24+00:00,うちの子の風野茉礼くんのような絵しか描かない誰得AIです(？？？？)しかも精度微妙誰でもボタンを押すだけで茉礼の画像が生成できます♥https://t.co/DH0xD8d00x#機械学習#うちの子#ichistar https://t.co/BnAraxdAMC,24,11,831,282,https://twitter.com/ssohsn/status/1556665135099326464,35
1556592409915854849,KMoco0109,2022-08-08 10:45:25+00:00,機械学習というワードにつられて購入した…！中身は帰ってからでとりあえずワンピース見てきます！😊#機械学習 #駆け出しエンジニアと繋がりたい https://t.co/cTQetAkrld,18,1,72,46,https://twitter.com/KMoco0109/status/1556592409915854849,19
1556232936839684096,griddb_jp,2022-08-07 10:57:00+00:00,心不全の予測：https://t.co/u1vpKmKQHm#opensource #oss #python #griddb #machinelearning #ml #kaggle#機械学習 #オープンソース #駆け出しエンジニアとつながりたい  #駆け出しエンジニアと繋がりたい #データサイエンス #心不全,31,7,1898,1560,https://twitter.com/griddb_jp/status/1556232936839684096,38
1556218610120400896,ryosei_ptworks,2022-08-07 10:00:04+00:00,VR旅行とかやってみたいhttps://t.co/DfVsYTiTc6#メタバース #エンジニア #機械学習  #ディープラーニング,11,0,1410,528,https://twitter.com/ryosei_ptworks/status/1556218610120400896,11
1555539130515263489,aoi_studyai,2022-08-05 13:00:03+00:00,👇今日の気になるAIニュース実はノイズ関数実装にも関係のある概念　ゲーム制作で使う、微分の考え方 https://t.co/Oakzedxk1t @logmi_techより 数学の「微分」について、黒板を使って丁寧に解説されています📚✨#AI #人工知能 #機械学習 #数学 #駆け出しエンジニアと繋がりたい,11,0,1865,1353,https://twitter.com/aoi_studyai/status/1555539130515263489,11
1555513908466958336,yasunori_cv,2022-08-05 11:19:50+00:00,弊社、Kaggler の阪田さんが社内メンバー対象に行ったコンペを記事化。このような実践的なデータを用いたグループ横断の活動をしています。#AI#機械学習#kaggle#研修 https://t.co/FHUS8yuuh4,10,3,199,359,https://twitter.com/yasunori_cv/status/1555513908466958336,13
1555468369205547008,panasonic_ai,2022-08-05 08:18:53+00:00,Kaggle Grandmasterの阪田が監修した社内向け機械学習コンペティションに関する記事を大公開！概要・裏話に加えてデータセットも公開していますので、夏季休暇のおともに是非腕試ししてみてください #AI #機械学習 #データサイエンス https://t.co/MC89aFKpaO,302,48,296,9,https://twitter.com/panasonic_ai/status/1555468369205547008,350
1555388122921197569,AxrossRecipe_SB,2022-08-05 03:00:00+00:00,購買履歴（レシート）データを層別解析で分析するレシピです。層別解析の基礎事項を学ぶことができます。飲食店における利用者の購買傾向分析に活用できます。https://t.co/MHqD0Wi4gt#AxrossRecipe#機械学習#統計学#プログラミング学習#駆け出しエンジニアと繋がりたい,14,0,1058,83,https://twitter.com/AxrossRecipe_SB/status/1555388122921197569,14
1555069403485839360,ssohsn,2022-08-04 05:53:32+00:00,【お知らせ】のほしおイラスト素材集537枚配布しますイラスト生成AIとか機械学習などにお使いいただけますよろしくお願いします😁https://t.co/0CpiibxnyG#機械学習#データセット,76,45,831,282,https://twitter.com/ssohsn/status/1555069403485839360,121
1555025742102237184,aoi_studyai,2022-08-04 03:00:02+00:00,👇今日の気になるAIニュース【福田昭のセミコン業界最前線】高性能プロセッサの祭典「Hot Chips 34」でIntel、AMD、NVIDIAが最新技術を披露 - PC Watch https://t.co/M0ppf08KpG @pc_watchより 8月21日～23日、GPU関係の最新情報が発表されます💻✨#機械学習 #駆け出しエンジニアと繋がりたい,10,0,1865,1353,https://twitter.com/aoi_studyai/status/1555025742102237184,10
1555014173720866817,jp_kndl,2022-08-04 02:14:04+00:00,"【8/4 Kindle日替わりセール】本日限定で、『Python機械学習プログラミング』が4,400円 → 499円となっています！#Python#機械学習#データ分析 #プログラミング初心者#駆け出しエンジニアとつながりたいhttps://t.co/uiic6dOBLZ",10,0,540,419,https://twitter.com/jp_kndl/status/1555014173720866817,10
1554814351579549696,aoi_studyai,2022-08-03 13:00:03+00:00,👇今日の気になるAIニュースStep関数～中学生から分かるAI数学(1-1) [E資格対応]https://t.co/6NCZp4MvVe中学校や高校の数学を、簡単に解説しています📚✨#AI #人工知能 #機械学習 #数学 #駆け出しエンジニアと繋がりたい,12,1,1865,1353,https://twitter.com/aoi_studyai/status/1554814351579549696,13
1554784150233571328,AxrossRecipe_SB,2022-08-03 11:00:02+00:00,【おススメ機能紹介】レシピを探す際に、「新着レシピ」「人気レシピ」順に並べ替えをすることができます！自分に合ったレシピが見つかりますように！🙏https://t.co/98OAX6jpzh#AxrossRecipe#機械学習 #プログラミング学習#駆け出しエンジニアと繋がりたい https://t.co/2HUyWYVjMR,12,2,1058,83,https://twitter.com/AxrossRecipe_SB/status/1554784150233571328,14
1554663344723804161,AxrossRecipe_SB,2022-08-03 03:00:00+00:00,Pythonと数理最適化 (pulpとfolium）によって施設配置の最適化を算出し、「効率的に店舗に商品配送するにはどこに倉庫を置くべきか」といった物流課題を解決するレシピです。https://t.co/ZrbfleZHXI#AxrossRecipe#機械学習 #プログラミング学習#駆け出しエンジニアと繋がりたい,15,1,1058,83,https://twitter.com/AxrossRecipe_SB/status/1554663344723804161,16
1554474913582698503,ai_gajumaru,2022-08-02 14:31:14+00:00,製造業はきれいなデータが揃っている事が多い。むしろ製造プロセスごとに項目数が多すぎて困惑する事がある。#AI #機械学習 #人工知能,15,2,245,271,https://twitter.com/ai_gajumaru/status/1554474913582698503,17
1554451964552814592,aoi_studyai,2022-08-02 13:00:03+00:00,👇今日の気になるAIニュース[HyperStyle] 任意の画像を高精度に潜在空間に投影するhttps://t.co/yrav0jy51i中間画像を生成する方法について、ソースコード＆実装方法が分かりやすく記載されています📚✨#AI #人工知能 #機械学習 #Python #駆け出しエンジニアと繋がりたい,12,0,1865,1353,https://twitter.com/aoi_studyai/status/1554451964552814592,12
1557924845559627776,AxrossRecipe_SB,2022-08-12 03:00:02+00:00,「DRUNet」というディープラーニングを用いた画像のノイズ除去のアルゴリズムを学ぶレシピ。ディープラーニングによる画像のノイズ除去、画像回復アルゴリズム開発に活用できます。https://t.co/f78Owccuzr#AxrossRecipe#画像処理#プログラミング学習#駆け出しエンジニアと繋がりたい https://t.co/mNv6rd1zUS,15,0,1058,83,https://twitter.com/AxrossRecipe_SB/status/1557924845559627776,15
1557880698496684032,cf_kaneiken,2022-08-12 00:04:37+00:00,研究の夢我々は光化学スモッグを予測する人工知能を開発しています。予測アルゴリズムは多変量データをディープラーニング、時系列予測。データ量も多いので、高性能GPUを積んだマシンが必要です！！8/18まで残り６日、ぜひご支援を！！https://t.co/vTf7vjPbwG#駆け出しエンジニアと繋がりたい https://t.co/2GBuRYXy6B,19,1,20,24,https://twitter.com/cf_kaneiken/status/1557880698496684032,20
1557751918445080577,chima_happy5,2022-08-11 15:32:53+00:00,今日は英語とPython.英語は単語とTOEIC。Kaggle本でディープラーニングに少し触れてみた。いろいろと新しいものが学べて楽しい,13,0,878,175,https://twitter.com/chima_happy5/status/1557751918445080577,13
1557708522737250304,RirahoRiraho,2022-08-11 12:40:27+00:00,夜活はディープラーニングの数学。実装するつもり満々でMacスタンバってましたが、あと3ページ及ばず🥺損失関数の偏微分はやはり難しいydをwで偏微分するとxが出てくるんだけど、ydの中身は本を見返さないと忘れてしまってて理解に時間がかかっております笑まもなく降下勾配法の詳細✨P182まで。,44,0,1319,639,https://twitter.com/RirahoRiraho/status/1557708522737250304,44
1557592646448971777,masayan_kazu,2022-08-11 05:00:00+00:00,FSDの初期は確かにまともに使えなかったけど学習ふやしてフィードバック使って鍛えたら実用的になってきた今頃ネガキャン始めても少しは遅く出来るかもだが既にリアルワールドに展開してるんだからネガキャン誤魔化しは時間の無駄だろディープラーニングの初期にAI画像認識なんてまともに使えない↓,13,1,1296,1502,https://twitter.com/masayan_kazu/status/1557592646448971777,14
1557359188287705095,UUselfstudy,2022-08-10 13:32:19+00:00,今日のぶん☑︎#udemy DS25時間Boot Camp 272-287数学パートはさらっと終わり。次からはディープラーニング。 #python #プログラミング初心者,31,0,175,228,https://twitter.com/UUselfstudy/status/1557359188287705095,31
1557342658443771905,RirahoRiraho,2022-08-10 12:26:38+00:00,"ガイダンス確率統計、P5 事象まで。やはり集合の表記に慣れず時間がかかりました。( a,b ]こういうやつとか。対象差がどこの部分を言ってるのか考えた結果、ネットで調べたらすぐ分かった。なーんだと😅なんとかやっていけそう笑ディープラーニングの数学も実装に入ってくるので忙しくなります🥺",28,1,1319,639,https://twitter.com/RirahoRiraho/status/1557342658443771905,29
1557186830260645888,Kojiro__Saito,2022-08-10 02:07:26+00:00,『画像／音声処理やディープラーニング、ドローンの姿勢制御など、さまざまな実機開発を解説するほか、6カ月間の無料ライセンスも読者限定で用意』夏休みの自由研究にも良いですよ～ MATLABを用いた実機開発を特集――「Interface」の2022年9月号を発刊　CQ出版社https://t.co/xga5COvH4U,13,2,293,221,https://twitter.com/Kojiro__Saito/status/1557186830260645888,15
1556999761827602433,runi_researcher,2022-08-09 13:44:05+00:00,🟢G検定ディープラーニングに入り、これはいかん！状態に😱さっぱり分からないレベルに入りましたので、ここからはテキストと動画で補足を得ることに。理解できるようになったら、世界が広がるはず。それからPythonも使えるように勉強して✨と妄想だけは楽しく膨らみます。とりあえず、やる。,21,0,90,92,https://twitter.com/runi_researcher/status/1556999761827602433,21
1556952055712886784,TsubasaNaitou,2022-08-09 10:34:31+00:00,AI案件の構成を作成中。前回執筆した「ディープラーニング」に続き、今回は「転異学習」について執筆する。転移学習とは、機械学習のひとつの手法。あるタスクで学習した知識を、別の領域の学習に適用させる技術。画像認識、音声認識、自然言語処理など、広い分野で活用されている＃Webライター,15,0,111,24,https://twitter.com/TsubasaNaitou/status/1556952055712886784,15
1556588110884241408,RirahoRiraho,2022-08-08 10:28:20+00:00,ディープラーニングの数学。ワイが２日悩んだことを秒で解決して下さいました✨✨✨まさにこの部分で？？になりました。今日はぐっすり眠れます😆 https://t.co/aWGDPEKOXB,19,1,1319,639,https://twitter.com/RirahoRiraho/status/1556588110884241408,20
1556584139360706561,RirahoRiraho,2022-08-08 10:12:33+00:00,しごおわ〜VBAのfor文の中のIF文で躓いて、社内のエキスパートに聞いて事なきを得ました｡ﾟ(ﾟ´Д｀ﾟ)ﾟ｡参照先のセルは混在させたらダメなのね。。大変勉強になりました🙇‍♀️帰ったらディープラーニングの数学の続きやります。統計に入りました。忘れてそうで怖いっ😱,31,0,1319,639,https://twitter.com/RirahoRiraho/status/1556584139360706561,31
1556247343371915265,hibs_MATLAB_Amb,2022-08-07 11:54:14+00:00,"MATLAB Academyにある""ディープラーニング入門""で学んだことを生かすべく, 留学中に旅行した* ツェルマット* ウィーン&amp;ブダペスト* アイスランドの写真の判別を転移学習で再チャレンジ.DL初心者で理論とかはほとんど知らない(これから勉強する)が,実装はかなり簡単だった!!#MATLAB https://t.co/ChVfTQwff4",12,0,887,1568,https://twitter.com/hibs_MATLAB_Amb/status/1556247343371915265,12
1556218610120400896,ryosei_ptworks,2022-08-07 10:00:04+00:00,VR旅行とかやってみたいhttps://t.co/DfVsYTiTc6#メタバース #エンジニア #機械学習  #ディープラーニング,11,0,1410,528,https://twitter.com/ryosei_ptworks/status/1556218610120400896,11
1556210070845009920,yangbo_youhaku,2022-08-07 09:26:08+00:00,Very Interesting !ディープラーニングと脳の関係とは？ 人工ニューロンや再帰型ニューラルネットワークを解説：CodeZine（コードジン） https://t.co/N7GFaw5sEP via @codezine https://t.co/zhxeTQWdJC,25,6,18,134,https://twitter.com/yangbo_youhaku/status/1556210070845009920,31
1556201527772979200,SmashBlack0190,2022-08-07 08:52:11+00:00,やっと第4章まで読み終えたので一杯やりたいと思います。🤤「からっぽのしょこ」さんのサイトが一番詳しく説明されており、大変助かってます。①でこんなに四苦八苦するとは､､､ディープラーニング舐めたらあかんですね。😓 https://t.co/00XbKmo3oF,39,0,638,375,https://twitter.com/SmashBlack0190/status/1556201527772979200,39
1556170573285572611,RirahoRiraho,2022-08-07 06:49:11+00:00,ディープラーニングの数学。softmax関数の証明で苦戦中。。gx1をx1で偏微分するくだりがよく分からない。(e ^x)'=e ^xだからってことでいいのかな？6〜7割くらい追えたので、今は一旦モヤりながら進んでしまおう✊…モヤリ箇所ふたつ目や😭P156に入ります。。,29,0,1319,639,https://twitter.com/RirahoRiraho/status/1556170573285572611,29
1556112903157288963,AxrossRecipe_SB,2022-08-07 03:00:01+00:00,【2022年７月人気有料レシピ】 1位：BERTによるQAチャットボットの学習モデル作成レシピ2位：三次元点群のディープラーニング3位：Transformer による長期時系列予測するレシピ https://t.co/JPb3ggJOnR #AxrossRecipe  #駆け出しエンジニアと繋がりたい https://t.co/mPK1QvhYPw,29,3,1058,83,https://twitter.com/AxrossRecipe_SB/status/1556112903157288963,32
1556055104037572608,reading_earth,2022-08-06 23:10:21+00:00,#G検定 #IT#AI#駆け出しエンジニアと繋がりたい G検定対策辞典：https://t.co/i6zJZg1OLz深層強化学習ディープラーニングを使用した強化学習の事。代表的な例として、googleの子会社であるdeep mind社が活用したDQNが有名。（DQN≠頭のおかしい奴） https://t.co/dsyHhJXyxR https://t.co/KV8IgfQzd6,11,0,542,382,https://twitter.com/reading_earth/status/1556055104037572608,11
1555895623328890881,RirahoRiraho,2022-08-06 12:36:38+00:00,よし。とりあえずシグモイド関数の数式は追えた。なお内容を理解したわけではない。なんでイコールにした数式に合成関数の微分を使っていいのかとかは分かりません(　･`ω･´)ｷﾘｯ現場からは以上です。ディープラーニングの数学でした。,45,1,1319,639,https://twitter.com/RirahoRiraho/status/1555895623328890881,46
1555895039687299074,attsu_of_death,2022-08-06 12:34:19+00:00,AIで4K処理とフレーム補間って感じなのかな？こういうの観るとディープラーニングとかもう少し勉強しとけば良かったなとは思ったりするけど、そんなぬるい思いでやり始めると痛い目に遭うことも俺は知っている。にしてもすげー。https://t.co/G7017Oblbn,13,0,375,336,https://twitter.com/attsu_of_death/status/1555895039687299074,13
1555823726222254081,chu_outdoor,2022-08-06 07:50:56+00:00,野球もそうだけど、剣道も審判のAI化は必要だと思う。いや、審判は人でいいのだけど、ディープラーニングだけでもさせておけば審判講習に使えるじゃん。今年の道連全国とかインターハイとか、地域でこんなに子供達の試合のやり方、審判の基準が違うのはかなりキツい。,11,1,304,345,https://twitter.com/chu_outdoor/status/1555823726222254081,12
1555690948231036928,RirahoRiraho,2022-08-05 23:03:20+00:00,おはようございます⛅️5:30起床今朝は、対数と指数関数の微分。説明されれば分かるけど、もうちょっと問題解かないとふ〜んで終わってしまう。。こういうのだいたい合成関数になってるんな。ディープラーニングの数学も併せてP146まで。半分くらいってとこか。,35,1,1319,639,https://twitter.com/RirahoRiraho/status/1555690948231036928,36
1555357705996419072,T_suto0831,2022-08-05 00:59:08+00:00,ディープラーニング？何それ？って時に読みました。オライリーの割には、ずいぶん優しい。少しわかった気がします。プログラミングスクールに行って高いお金を使うのは自由ですが、3千円程度の本でも得るものは大きいですよ。 https://t.co/iPe7TLwBoC,18,3,977,2627,https://twitter.com/T_suto0831/status/1555357705996419072,21
1555337198698119170,makaishi2,2022-08-04 23:37:39+00:00,Pytorch本を最後まで読んでいただいた方は、Pytorchのコードは大体読めるようになっているはずです。でも、なせこの計算で学習ができるのかは、ぼんやりしていると思います。「ディープラーニングの数学」は、そのモヤモヤを解決できる本です。高校１年の数学を出発点にしていますので、是非お試しを！ https://t.co/9vpkj3Vp6Y,21,1,1049,698,https://twitter.com/makaishi2/status/1555337198698119170,22
1557568344982974464,kitayuta,2022-08-11 03:23:26+00:00,データサイエンティストの北村さん…… 一体誰なんだ…… https://t.co/j1h3dn3JZ6,13,0,172,370,https://twitter.com/kitayuta/status/1557568344982974464,13
1557476624601296897,ImoyKiss,2022-08-10 21:18:58+00:00,データサイエンティストを職業にするにはノー勉で年齢的に厳しい。だけど近づけるように学んでいくのです。数年後に自称データサイエンティストになる…。勉強に挫折したくないな…誰かに何かを提言するときに、わかってもらいやすいようにしたい。自信をつけたい。美味しいカルボナーラ食べたい。,22,0,29,77,https://twitter.com/ImoyKiss/status/1557476624601296897,22
1557361678743793665,Ayame_yurulife,2022-08-10 13:42:13+00:00,お疲れ様です！CPIは無事通過しましたね～✨(遅い)ERXを今のうちに利確しました✊私は明日から四連休なので何をしようかな～とワクワク計画中🥰データサイエンティストになるべく最近pythonを勉強し始めたので休み中も頑張ろうかな…🤔,36,0,540,319,https://twitter.com/Ayame_yurulife/status/1557361678743793665,36
1557306583314354177,miri1113n,2022-08-10 10:03:17+00:00,「困ったな〜」「トウ！データサイエンティスト登場！解析すべきデータはあるかね？」「こ、こちらです！」ｶﾀｶﾀｶﾀｯﾀｰﾝ「さぁ、これでもう大丈夫！あとはAIの言うことをよく聞きたまえ！」「ありがとう、データサイエンティスト！ありがとう、データサイエンティスト！」,11,0,1041,1323,https://twitter.com/miri1113n/status/1557306583314354177,11
1557303511754231810,ttake104,2022-08-10 09:51:05+00:00,『独学で』未経験からデータサイエンティストになられた@chima_happy5 さんの貴重な経験が共有されています。是非ご参考に。私の経験とも重なり、激しく共感できるものでした❗️⬇️詳細、気になる方は記事へhttps://t.co/2F4PeFw1Te https://t.co/MKJf5QcREC,12,1,385,97,https://twitter.com/ttake104/status/1557303511754231810,13
1557282363066880000,RPA_Journey,2022-08-10 08:27:02+00:00,ボストン大学はMBAがオンラインで取れる😲データサイエンティストも多い！社内人材育成の一環で社員を海外留学させてる企業は、こういう制度使えば（従来よりは）低コストになるのでは。 https://t.co/o2faG5Nj6r,13,4,1097,174,https://twitter.com/RPA_Journey/status/1557282363066880000,17
1557236001541861378,A7_data,2022-08-10 05:22:49+00:00,データサイエンティストには統計検定2級があれば大体OKみたいなこと聞いたことがあるんだけど、準1級の内容結構重要なの多くない？使わないのかな,31,0,722,538,https://twitter.com/A7_data/status/1557236001541861378,31
1557193031878467584,ranrantech,2022-08-10 02:32:04+00:00,こちら半分くらい書き終わっているのですが、文量が多いので、何部構成かにする予定です。とくに転職のコツは必ず伝えたい。データサイエンティスト枠は独自の筆記試験を設けていたりしますし、職務経歴書も2ヶ月かけて書いて良かったと思うくらいには大事でした。今週末第1弾を投稿予定です https://t.co/SUiIVD0J8T,11,0,560,401,https://twitter.com/ranrantech/status/1557193031878467584,11
1557188063826038784,estie_corp,2022-08-10 02:12:20+00:00,【ブログ更新🗾】データサイエンティストの齊藤です。今日はPLATEAUを使って23区のビルを集計してみました！不動産データ、面白いのでぜひご一読ください！https://t.co/PzwRSRgZy3,32,4,669,85,https://twitter.com/estie_corp/status/1557188063826038784,36
1557155406073708544,HacarusInc,2022-08-10 00:02:34+00:00,【イベントレポート】 8/7に開催されたJAWS-UG京都 のイベントレポートです。ハカルスからはデータサイエンティストの宇佐見 @USAvich_1p とアプリケーションエンジニアの内野 @ucn_hiro が登壇しました🎤 #エンジニア  #jawsug #AI #機械学習 https://t.co/aH8VtMlKb7,19,4,548,41,https://twitter.com/HacarusInc/status/1557155406073708544,23
1557130468604399616,Jin_Neuron,2022-08-09 22:23:28+00:00,データサイエンティストっていうデータ分析のスペシャリストがいるんですが、実はその人達にデータを提供するデータベースエンジニアって人がいてその人達のおかげで全部成立するらしい,14,2,610,594,https://twitter.com/Jin_Neuron/status/1557130468604399616,16
1557053321390592000,rYmrltzuUbvooez,2022-08-09 17:16:55+00:00,【自己紹介】●大学→早慶上理●サークル→テニス●アルバイト→塾講師●長期インターン→データサイエンティスト●TOEIC →600●志望業界→幅広く#24卒 #24卒と繋がりたい #24卒就活 ＃24卒とつながりたい,52,2,15,5,https://twitter.com/rYmrltzuUbvooez/status/1557053321390592000,54
1557013378832695297,A7_data,2022-08-09 14:38:12+00:00,参考にしたいデータサイエンティストの人とか、データサイエンティストなるために勉強してる人が何してるかイマイチわかんないから、データサイエンティストになるために勉強したことまとめるYouTubeでも始めようかな,28,0,722,538,https://twitter.com/A7_data/status/1557013378832695297,28
1557009297238032385,huehuki,2022-08-09 14:21:58+00:00,私の弟はADHDで、療育センターや通級指導教室に通っていて、人の目を見て話せないから就活で30社以上から落とされたけれど、今ではたんまり稼いで、スキルアップの転職も成功して、社会に必要とされるデータサイエンティストになったので、フルリモートの社会も悪くない。むしろ、彼らには希望しかない,13,0,732,306,https://twitter.com/huehuki/status/1557009297238032385,13
1557006553907347457,huehuki,2022-08-09 14:11:04+00:00,生活費を稼ぐ為に働くというよりかは、運用資金を増やす為に働くってモチベーションで働いているので、気持ちに余裕を持って本業に臨める。私の場合は弟が金融関係のデータサイエンティストなので、弟にマネジメントしてもらって着々と不労所得が増えている。暮らしも気持ちも余裕があっていい。,10,0,732,306,https://twitter.com/huehuki/status/1557006553907347457,10
1556991681538707456,ouj_10years,2022-08-09 13:11:59+00:00,独学コンピューターサイエンティスト Pythonで学ぶアルゴリズムとデータ構造　https://t.co/Iv7YUbUeno放送大学のアルゴリズムとプログラミング＋データ構造とプログラミングという感じの内容でとても良さそう。C言語でもいいけどもう少し気軽に書きたいと思う時があるからPythonだと嬉しい。,11,2,1090,1795,https://twitter.com/ouj_10years/status/1556991681538707456,13
1556971987309694976,kaggle_hokudai,2022-08-09 11:53:43+00:00,原動力ってやっぱり憧れだと思うので、データサイエンティストの皆さんは是非自分の仕事のかっこよさをドヤ顔でツイートして欲しいです。,11,0,1728,781,https://twitter.com/kaggle_hokudai/status/1556971987309694976,11
1556954911698751489,rinchi_math,2022-08-09 10:45:52+00:00,本日、最終出社日でした。1年半と短い期間でしたが、たくさんの方にお世話になりました。9月からは新しい会社で、データサイエンティストとして働きます！ https://t.co/opphzgMPIU,49,1,587,721,https://twitter.com/rinchi_math/status/1556954911698751489,50
1556851021997023232,OmathinB,2022-08-09 03:53:03+00:00,AidemyとUdemyは、そもそも運営会社が違うので、学べる内容やサービス形態まで何もかもが違います。実際にAidemyとUdemyを受講ましたが、この2つを使い分ければデータサイエンティストになるための知識は十分です #プログラミング初心者 #駆け出しエンジニアと繋がりたいhttps://t.co/f7nlr5PTDV,16,0,611,173,https://twitter.com/OmathinB/status/1556851021997023232,16
1556837946556387331,pypy1225,2022-08-09 03:01:05+00:00,データサイエンティストの業務はイメージより地味。注目されている分、クリエイティブで華やかな職業と思われがちだけど全然そんなことない。実際は地道なデータ集め・ラベリング・分析が大半。作業内容的には、副業でやってるアプリ開発の方が圧倒的に楽しい。#駆け出しエンジニアと繋がりたい,65,1,593,597,https://twitter.com/pypy1225/status/1556837946556387331,66
1556747391323484160,nichiden1951,2022-08-08 21:01:15+00:00,#データサイエンティスト とは、 ビッグデータを分析し、分析結果をもとにビジネスやシステム開発時に適切な提案をします。 膨大なデータ（ビッグデータ）を活用し、確度の高い将来予測を可能にするデータサイエンティストは将来有望な職種です。 #日本電子専門学校 #AIシステム科,12,3,1206,238,https://twitter.com/nichiden1951/status/1556747391323484160,15
1556735251979808769,kodenkoden,2022-08-08 20:13:01+00:00,転職の面接受けてるとプロフに書いてあるキャリアを見た面接官から「よくデータサイエンティストの部署へ異動できたね」と驚かれる。結果に結びつけて資格と希望をアピールして後は運。仕事で学んだことツィートしていきます。#仕事 #転職 #駆け出しエンジニアと繋がりたい #社会人,16,0,492,215,https://twitter.com/kodenkoden/status/1556735251979808769,16
1556632584716943363,kaji_fish_dx,2022-08-08 13:25:03+00:00,会社のロゴ制作をデザイナーの妻に頼んでる。まだ制作途中だけど、すでに超カッコいい。テンションあがる。あとはデータサイエンティストのピースだけだな,11,0,1900,2168,https://twitter.com/kaji_fish_dx/status/1556632584716943363,11
1556574298692657153,sasisu89j,2022-08-08 09:33:27+00:00,僕のフォロワーさんはエンジニアとデータサイエンティストが多い印象です。できればマーケターの方とも、繋がりたいですね、、、#マーケティング,11,0,361,284,https://twitter.com/sasisu89j/status/1556574298692657153,11
1556546409150967809,PythonStartLab0,2022-08-08 07:42:37+00:00,お疲れ様です☺️新規開講のデータサイエンティスト入門コースはちえっくしていただけましたでしょうか？！#データサイエンス にちょっとでも興味がある方、登録から３日間は完全無料で受講できるので気軽にチェックしてみてくださいね♩#プログラミングスクール #プログラミング初心者 #スタートラボ https://t.co/RyIoDIdHLQ,11,0,542,626,https://twitter.com/PythonStartLab0/status/1556546409150967809,11
1556519422872784897,lilika33523506,2022-08-08 05:55:23+00:00,JPモルガン・チェースという銀行は世界のあらゆる銀行の中でも、化石燃料プロジェクトにもっとも多くの資金をつぎ込んでいる！NASAのデータサイエンティストの警告を無視する世界って破滅しかなくない⁈そして、このニュースがおもしろびっくりというカテゴリーなの？🫢 https://t.co/wwXaMuchTu,14,2,339,354,https://twitter.com/lilika33523506/status/1556519422872784897,16
1556457030197452801,NieR_in_,2022-08-08 01:47:28+00:00,データサイエンティストに必要なスキルどれを自分で伸ばしたいか答.全部です。（5文字）,13,0,274,266,https://twitter.com/NieR_in_/status/1556457030197452801,13
1556277170217287681,suzulan_china,2022-08-07 13:52:46+00:00,みなさんは、どんなときに「人との繋がり」と感じますか？私は宇宙の研究者の話を聞いて宇宙の解説動画見たり、データサイエンティストの方の影響で統計学の本を読んだりするときに感じます！人生に良い影響を与え合える人間関係、これからも大事にしていきたいですね☺️🌸,10,0,577,718,https://twitter.com/suzulan_china/status/1556277170217287681,10
1556267683062095876,pypy1225,2022-08-07 13:15:04+00:00,データサイエンティスト検定って知らなかったけど、問題見てみるとかなりいい試験。教本ではデータサイエンティストに必要な知識が体系的にまとめられててわかりやすい。問題も単なる暗記ゲーじゃないし、実務に則した出題になっててイメージを掴みやすい。#駆け出しエンジニアと繋がりたい,46,1,593,597,https://twitter.com/pypy1225/status/1556267683062095876,47
1556257536973897728,tera_ai_science,2022-08-07 12:34:45+00:00,1000時間以上勉強して公務員になるなら、データサイエンス勉強した方が良かったなー。給料、自由、将来性全てデータサイエンティストの方が上だった。地元に残りたいならエンジニア数年からのフルリモート企業への就職で達成出来るし。,17,0,42,97,https://twitter.com/tera_ai_science/status/1556257536973897728,17
1556240953211764736,kaneVYMVIG,2022-08-07 11:28:51+00:00,セミリタイア妄想40歳で純金融資産1億、S&amp;P5000万円(可能なら6000万)1年のんびりし、レーシック、進行してるはずの薄毛治療wするフリーデータサイエンティストとして、1年の半分か8割稼働で働くFP1級と学歴、経歴を売りに全うな投資講座の講師をフリーでするできたら個人法人作る,106,3,442,422,https://twitter.com/kaneVYMVIG/status/1556240953211764736,109
1557883633935200261,npnmk250,2022-08-12 00:16:17+00:00,@ZizzREF 最近awsの資格の勉強をしてますが、awsも物凄く優れたサービスだけど、あくまで「顧客のビジネスを効率良くする」だけで、ビジネス自体を生み出すわけではないんですよね。AIも機械学習もデータサイエンスも同じで、あくまで人間のやりたいことを実現するためのサポートツールでしかないというか。,13,7,167,1241,https://twitter.com/npnmk250/status/1557883633935200261,20
1557734798394683393,asalworld,2022-08-11 14:24:51+00:00,【ガチレビュー】CodeCampのPythonデータサイエンスコースの全て！料金や評判まとめ https://t.co/owhAXiDrac #CodeCamp#コードキャンプ #Python #Python3#Python1年生 #pythonlearning #AI#駆け出しエンジニアと繋がりたい,12,2,1199,863,https://twitter.com/asalworld/status/1557734798394683393,14
1557617119130714113,Knan_demo,2022-08-11 06:37:14+00:00,アイシアさんの「分析モデル入門」 を購入したよ❗データサイエンスの全領域の分析モデルを解説っていうことで、知らない単語だらけの未知の領域の本なのだけど。文章は平易⁉かも。索引と用語の説明がしっかりしてるので、辞書的な使い方もできそう。なにより読んでいて、わくわくする😆 https://t.co/i5y6H9VMVu,31,6,509,515,https://twitter.com/Knan_demo/status/1557617119130714113,37
1557493241309630464,s_komaki_nkr,2022-08-10 22:25:00+00:00,弊社データサイエンスのインターンシップ、「データサイエンス×インサイトBiz 2Weeks Hackathon」が来週から始まります🎉お題は投稿でもたびたび紹介しているブランドDB。学生の皆さんからどんなアイディアが出るかとても楽しみ😆。https://t.co/ehRwSCeEIU https://t.co/FV7sMngxn0,13,0,1256,1239,https://twitter.com/s_komaki_nkr/status/1557493241309630464,13
1557456198156177408,koudai02007,2022-08-10 19:57:48+00:00,おはようございます😊今日は、データサイエンスと基本情報技術者の勉強を進めていきます😆VPNが分かっていないので、これを中心に頑張ります💪,25,0,339,426,https://twitter.com/koudai02007/status/1557456198156177408,25
1557386309303353348,nobushoshin,2022-08-10 15:20:05+00:00,「データサイエンスのためのPython入門」本日は第21回まで。https://t.co/rV4yvVuJ1Bpandas編を終え、matplotlibによるグラフの描画が始まりました。なるほど、コード書くだけで綺麗なグラフが描かれるんですね！😯#プログラミング初心者,11,0,91,35,https://twitter.com/nobushoshin/status/1557386309303353348,11
1557370463356985350,phys_yoshiki,2022-08-10 14:17:07+00:00,素粒子論グループなのに、素粒子論よりデータサイエンスの公募の方が多いな,15,3,1003,155,https://twitter.com/phys_yoshiki/status/1557370463356985350,18
1557342243811315712,yokubaribambids,2022-08-10 12:24:59+00:00,明日予定あると思ってたら別の日と勘違いしてて一日フリーになった🙄というわけで、仕事のスピードアップのためにもSQLの勉強しようと思います💪データサイエンス100本ノックやる！どの教材よりもクエリの勉強になる👍,17,0,1694,249,https://twitter.com/yokubaribambids/status/1557342243811315712,17
1557302193967202309,stat_CAL,2022-08-10 09:45:50+00:00,企業で統計検定が必要かどうか、私は知識さえあればいいとは思うけど、証明として有効だと思うから学生さんはとっておいて損はないよ。私が勤める会社は二級合格で報奨金3万出ます！そしてデータサイエンス未経験だとせめて統計検定ぐらいあって欲しいと上層部は考えているみたいです。,20,1,34,56,https://twitter.com/stat_CAL/status/1557302193967202309,21
1557280824281616385,FUFNaPyPdt3DIa0,2022-08-10 08:20:56+00:00,Pythonでデータサイエンスがそこそこできるようになって涙,12,0,1075,745,https://twitter.com/FUFNaPyPdt3DIa0/status/1557280824281616385,12
1557265222141784064,kyoubun_center,2022-08-10 07:18:56+00:00,信大連携サイエンスカレッジ8/10信大の三澤透先生と、欧州宇宙南天天文台VLTのデータを使った最新の「宇宙地図」を作りました。一人一つずつ別のクェーサーを担当し、PCソフト「dude」等を使って炭素ガスの吸収線を探しました。（図のピンクの点）恐らく他では例のない最新の地図が完成しました。 https://t.co/pg2XFiAtyn,21,2,549,75,https://twitter.com/kyoubun_center/status/1557265222141784064,23
1557225437503569920,kuronekoongaesi,2022-08-10 04:40:50+00:00,これぞデータサイエンス https://t.co/SgiUlJCHqI,17,12,500,604,https://twitter.com/kuronekoongaesi/status/1557225437503569920,29
1556998613418782721,__ot_kame,2022-08-09 13:39:31+00:00,数理データサイエンス今から追い上げます。みんな待っててくれ,9,0,107,87,https://twitter.com/__ot_kame/status/1556998613418782721,9
1556958475187392513,dsmatome_,2022-08-09 11:00:02+00:00,"新着記事｜【2022年版データサイエンスの学び方】""データサイエンスを学ぶのに最適な方法は何か？""今回の記事では海外で有名な学習プラットフォーム「Dataquest」の創始者がその答えを語っています👀#データサイエンス#機械学習#AIhttps://t.co/HfvLz3kFBM",14,2,27,1,https://twitter.com/dsmatome_/status/1556958475187392513,16
1556946510834978820,ExploratoryJP,2022-08-09 10:12:29+00:00,現在、Exploratoryを共に開発していただけるエンジニアの方を募集しています！「データサイエンスの民主化」という私達のミッションに共鳴いただき、興味をもっていただけましたら、是非、ご応募ください！https://t.co/uEqJdoWO2U,15,7,359,13,https://twitter.com/ExploratoryJP/status/1556946510834978820,22
1556933936630362118,TanaritsuEuph,2022-08-09 09:22:31+00:00,データサイエンス耐えなかった♡,16,4,212,280,https://twitter.com/TanaritsuEuph/status/1556933936630362118,20
1556820117425627137,U_hiraku,2022-08-09 01:50:14+00:00,ネガデータも立派な進捗である（※異論は認めない）にしておこう。それがあるべきサイエンスの形よね,13,2,1284,640,https://twitter.com/U_hiraku/status/1556820117425627137,15
1556668638303662080,arshad_esq,2022-08-08 15:48:19+00:00,民衆の声ではなく、データに基づいたコロナ対策を日本政府にはしてほしいな。以下のデータが正確であれば、コロナはもう既にインフルエンザと同等。他の先進国も、全数PCR検査なんてもうとっくにやめている。なんとなくコロナが怖いという感情ではなく、サイエンスを見よう。 https://t.co/fNDTQTsOvo,17,4,1187,612,https://twitter.com/arshad_esq/status/1556668638303662080,21
1556641271879712769,nobushoshin,2022-08-08 13:59:34+00:00,「データサイエンスのためのPython入門」15まで進めました。https://t.co/iyDD2vcX7rpandasの使い方みるみるうちに忘れてしまいますが、先に進んでいこうと思います。実践的な課題に取り組むときに、また調べながら身につけていくつもりです🥹先が気になる・・・！#プログラミング初心者,10,0,91,35,https://twitter.com/nobushoshin/status/1556641271879712769,10
1556556337626025989,GSIS_Tohoku_U,2022-08-08 08:22:04+00:00,大関研・田中研主催、青森県立八戸高等学校の高校生を対象としたAI・数理・データサイエンス講座。3年ぶりの対面開催です！一日目の今日はオンラインで大関教授の講義を受講。リアルタイムでコメントを書き込みながら理解を深めていきます。講義の様子はこちら↓https://t.co/O3IzqxDUXQ https://t.co/qpB4Kv2XYU,16,3,1134,91,https://twitter.com/GSIS_Tohoku_U/status/1556556337626025989,19
1557713446778441728,aoi_studyai,2022-08-11 13:00:01+00:00,👇今日の気になるAIニュース【保存版】オープンデータ・データセット100選  -膨大なデータを活用しよう！ https://t.co/6AbcpTU8xr 画像・テキスト・音声など、大量のデータセットがまとめられています。ぜひご活用ください📚✨#AI #人工知能 #機械学習 #駆け出しエンジニアと繋がりたい,18,1,1865,1353,https://twitter.com/aoi_studyai/status/1557713446778441728,19
1557351060309778439,aoi_studyai,2022-08-10 13:00:01+00:00,👇今日の気になるAIニュースAI活用企業は増加も専門知識不足が普及妨げ、IBM調査 https://t.co/gPUtJ6pTgSIBMの調査結果が掲載されています。中国とインドのAI導入率が凄く、50%を超えています…！💻✨#AI #人工知能 #IBM #駆け出しエンジニアと繋がりたい,15,0,1865,1353,https://twitter.com/aoi_studyai/status/1557351060309778439,15
1557312722685280256,the02282866,2022-08-10 10:27:41+00:00,下のお題で人工知能に描かせた絵　普通にすごい〜(2匹のボストンテリアが虹のかかる草原で遊ぶ）  （ボストンテリアの宇宙旅行）#Bostonterrier  #ボストンテリア#ボステリ #イラスト #犬 #art #いぬのいる暮らし  #ai #人工知能 https://t.co/PnXMHXAKBk,47,3,157,158,https://twitter.com/the02282866/status/1557312722685280256,50
1556885794597416960,data_artist_ai,2022-08-09 06:11:13+00:00,https://t.co/QumOnnkIwKDA x Qosmoの新サービス！「クリエイティブAI」に関してはお気軽にご相談ください！😀#AI #人工知能 #アート #音楽 https://t.co/L4dIvSBKPv,12,1,1560,170,https://twitter.com/data_artist_ai/status/1556885794597416960,13
1556813017966583809,SIOScorporation,2022-08-09 01:22:02+00:00,東大・サイオステクノロジー研究グループは日本産科婦人科学会学術講演会で「完全自動化に対応したMRI画像による子宮肉腫診断AIの研究成果」発表、「JSOG Congress Encouragement Award」を受賞しました。#子宮筋腫 #子宮肉腫 #MRI #人工知能 #AI #婦人科 #画像診断 #JSOGhttps://t.co/oNGo0OzOWi,21,0,979,50,https://twitter.com/SIOScorporation/status/1556813017966583809,21
1555881702157078528,senpuu818satsu,2022-08-06 11:41:19+00:00,人工知能がチルノを描いてくれましたぞhttps://t.co/YZanDBUl9x#閲覧注意 #人工知能 #東方Project #東方好きと繋がりたい #イラスト好きさんと繋がりたい #イラスト #Cirno #DALL·E #dalleMini https://t.co/tMv6W7b7Uh,24,2,2,28,https://twitter.com/senpuu818satsu/status/1555881702157078528,26
1555539130515263489,aoi_studyai,2022-08-05 13:00:03+00:00,👇今日の気になるAIニュース実はノイズ関数実装にも関係のある概念　ゲーム制作で使う、微分の考え方 https://t.co/Oakzedxk1t @logmi_techより 数学の「微分」について、黒板を使って丁寧に解説されています📚✨#AI #人工知能 #機械学習 #数学 #駆け出しエンジニアと繋がりたい,11,0,1865,1353,https://twitter.com/aoi_studyai/status/1555539130515263489,11
1554814351579549696,aoi_studyai,2022-08-03 13:00:03+00:00,👇今日の気になるAIニュースStep関数～中学生から分かるAI数学(1-1) [E資格対応]https://t.co/6NCZp4MvVe中学校や高校の数学を、簡単に解説しています📚✨#AI #人工知能 #機械学習 #数学 #駆け出しエンジニアと繋がりたい,12,1,1865,1353,https://twitter.com/aoi_studyai/status/1554814351579549696,13
1554474913582698503,ai_gajumaru,2022-08-02 14:31:14+00:00,製造業はきれいなデータが揃っている事が多い。むしろ製造プロセスごとに項目数が多すぎて困惑する事がある。#AI #機械学習 #人工知能,15,2,245,271,https://twitter.com/ai_gajumaru/status/1554474913582698503,17
1554451964552814592,aoi_studyai,2022-08-02 13:00:03+00:00,👇今日の気になるAIニュース[HyperStyle] 任意の画像を高精度に潜在空間に投影するhttps://t.co/yrav0jy51i中間画像を生成する方法について、ソースコード＆実装方法が分かりやすく記載されています📚✨#AI #人工知能 #機械学習 #Python #駆け出しエンジニアと繋がりたい,12,0,1865,1353,https://twitter.com/aoi_studyai/status/1554451964552814592,12
1557951491364864000,erno2041,2022-08-12 04:45:55+00:00,"@tokino_sora good afternoon Sora-chan, have a good time in the radio ヽ(✿ﾟ▽ﾟ)ノwould like to listen to it, but I'm a late sleeper, the night in Japan, is morning to me ( •́ .̫ •̀ )",11,0,171,5001,https://twitter.com/erno2041/status/1557951491364864000,11
1557950682120204289,nzuwzu,2022-08-12 04:42:42+00:00,東海道新幹線で移動中です。2人とも仲良く乗っていますよ💜❤️🫶#NiziU #WithU #NiziU_tour #livewithu2022 #Light_it_Up https://t.co/sdUHlfZEjQ,10,0,697,235,https://twitter.com/nzuwzu/status/1557950682120204289,10
1557948265559379968,irodoritch,2022-08-12 04:33:06+00:00,iT'S MEEEEEE!!!!!!(C100表紙絵) https://t.co/j3Uyd3C3xC,44,15,966,860,https://twitter.com/irodoritch/status/1557948265559379968,59
1557947778164109313,nizikkodoubutu,2022-08-12 04:31:10+00:00,🎉HAPPY BIRTHDAY MINKOOOOO!!!🎉🥳🌈💗🤩🐰「今日はパンたらふく食べて明日の初ライブに備えるで！！💪🤩パンうまい😋😘」　　　　　　by 虹っ子Jr🐰🐰🐰@NiziU__official#WithU_Light_it_Up#HappyMiihiDay#みひたん生誕祭#みいひちゃん #みんこ#パン#NiziU_Light_it_up #NiziU_tour https://t.co/p0e8UkQeKu,12,2,182,275,https://twitter.com/nizikkodoubutu/status/1557947778164109313,14
1557946608733790209,sanba27456728,2022-08-12 04:26:31+00:00,ROCK IN JAPAN FES. 2022PassCodeセトリ速報01 Ray 02 Taking you out 03 DIVE INTO THE LIGHT04 ATLAS 05 SPARK IGNITION06 FLVOR OF BLUE07 It’s you 多分合ってると思いますが、参戦された方、訂正あればよろしくお願いいたします‼️💦#RIJF22 #ロッキン #PassCode,24,0,83,107,https://twitter.com/sanba27456728/status/1557946608733790209,24
1557945961086717952,Kuni_Code1228,2022-08-12 04:23:57+00:00,ROCK IN JAPAN FESTIVAL 2022.8.12PassCode セットリスト少し長めのやちいのMCから！“10年かけてこのステージに立ちました。ROCK IN JAPAN PassCode始めます”RayTaking you outDIVE INTO THE LIGHT ATLASSPARK IGNITION FLAVOR OF BLUEIt’s you #RIJF2022 #ロッキン #PassCode,41,13,1552,666,https://twitter.com/Kuni_Code1228/status/1557945961086717952,54
1557945091318509568,JO1_Ren_K,2022-08-12 04:20:29+00:00,キノさんーーー😭✨💕蓮ちゃん音ハメさすが✨@official_jo1 #JO1｜With Us｜YOLO-konde｜Move The Soul｜Walk It Like I Talk It｜Algorithm｜ALL HOURSPENTAGON•펜타곤の投稿動画を楽しみましょう！#TikTok https://t.co/1N1YeFGzF6,10,15,853,792,https://twitter.com/JO1_Ren_K/status/1557945091318509568,25
1557944673758777344,rinacho414,2022-08-12 04:18:50+00:00,いざ小倉へ！！！#CLAP_CLAP #NiziU_Light_it_up#ASOBO #Chopstick Need U / Take a picture / Poppin' Shakin' / Step and a step / Make you happy #NiziU @NiziU__official https://t.co/SlcZRytGiM,13,0,1299,1291,https://twitter.com/rinacho414/status/1557944673758777344,13
1557944515436367872,vanvan1021,2022-08-12 04:18:12+00:00,この空の下で聴くATLASとラストのIt's youが凄く良かった。PassCode、初のロッキン本当におめでとう！最高のステージでした！！ https://t.co/3LNuEqF7As,15,1,563,899,https://twitter.com/vanvan1021/status/1557944515436367872,16
1557944185680203776,bigwjo1,2022-08-12 04:16:53+00:00,こんにちくわJO1とJAM🧏‍♂️💕#JO1 @official_jo1 With Us ⟴ Move The Soul ⟴ #僕らの季節 ⟴ Walk It Like I Talk It ⟴ Algorithm ⟴ ALL HOURS,17,22,1014,1047,https://twitter.com/bigwjo1/status/1557944185680203776,39
1557943227465969664,IT_TREK,2022-08-12 04:13:05+00:00,家族でアスレチック中#フォレストアドベンチャー #フォレストアドベンチャーおおすみ #ジップライン #アスレチック #鹿児島#曽於市#大隅町#家族旅行 #GR3 #RICOH https://t.co/4iI4gZsAhL,11,0,1257,1336,https://twitter.com/IT_TREK/status/1557943227465969664,11
1557943064777216000,bk_5_gira,2022-08-12 04:12:26+00:00,LA KCONのやつ見ましたか〜！？まだの方ぜひ👍ケーキデコレーションしてるかわいいJO1が見られます🎂CHECK IN 🙆‍♂️ | JO1 (제이오원) | KCON 2022 LA https://t.co/NdmuWc4MTN @YouTubeより #JO1 @official_jo1 #僕らの季節 / With Us / Move The Soul /  Walk It Like I Talk It / YOLO-konde,13,13,670,753,https://twitter.com/bk_5_gira/status/1557943064777216000,26
1557941520904253440,susan602698,2022-08-12 04:06:18+00:00,午前は仕事しながらステューシーGOT'ITして、午後は休んで息子とワンピース🟥少ない盆休み始まります😊 https://t.co/PY0R6Bd3Ge,19,0,448,522,https://twitter.com/susan602698/status/1557941520904253440,19
1557940908355887104,EGW4qILhTvJbaUW,2022-08-12 04:03:52+00:00,THE ANSWERさんに取材していただきました！異例 Jのエース→ITエンジニアに#Yahooニュースhttps://t.co/d57V6DGff7#セカンドキャリア#アスリート#コラボスタイル#IT#サッカー選手,112,31,1873,277,https://twitter.com/EGW4qILhTvJbaUW/status/1557940908355887104,143
1557940407266590720,To_do_it,2022-08-12 04:01:52+00:00,ご飯並んでますが、全く動きません… https://t.co/jLss3v1rEq,12,0,614,735,https://twitter.com/To_do_it/status/1557940407266590720,12
1557939163613212672,mayumit42472402,2022-08-12 03:56:56+00:00,この仕組みや日頃のメンテは災害になった時最大限パワーを発揮する。井戸水を復活させて共有したり、町の消防団の方が役所より到着がびっくりするくらい早かったり。気付くのはその時かな。IT化とか作業は効率化すべきやけど。全部じゃないけど、いいとこもある。,32,0,1373,1215,https://twitter.com/mayumit42472402/status/1557939163613212672,32
1557937310284787712,Ren_Ren_SR,2022-08-12 03:49:34+00:00,#祝_JO1無限大MV1600万回再生おめでとう🎊JO1とJAMにとって大切な曲ライブで生で見てみたいな😊#JO1 @official_jo1 With Us / Move The Soul #僕らの季節 / Walk It Like I Talk It / ALL HOURS / 無限大,10,19,1637,1718,https://twitter.com/Ren_Ren_SR/status/1557937310284787712,29
1557935861920329728,lanvin__,2022-08-12 03:43:49+00:00,明日迷子にならないように会場キプマしたわぁ😘中には入らないので、外周のみ確認思ったより蒸し暑いので帰ります🥵🦁🐥🦢🐿🦥😸🦙🐰🐶🌈#NiziU #CLAP_CLAP #Light_it_up #2022LIVE #マコ #福岡 #西日本総合展示場新館 #全通 #愛嬌 https://t.co/hG8KbOY0CH,73,3,885,893,https://twitter.com/lanvin__/status/1557935861920329728,76
1557935134170824704,yamyamNiziU,2022-08-12 03:40:55+00:00,"ダメだいよいよLIVE前日の興奮とみいひたんセンイルでTLが楽しくてスマホが置けない！いや準備進まないので1回スマホ置きます！(_･ω･)_ﾀｧﾝのちほどー♪( 'ω' و(و ""ｸﾏｰ#NiziU_tour  #NiziU_Light_it_up #CLAP_CLAP 👏 #NiziU @NiziU__official https://t.co/yxXhNcvE76",18,0,1635,1731,https://twitter.com/yamyamNiziU/status/1557935134170824704,18
1557935090831081472,hi6yuky,2022-08-12 03:40:45+00:00,"本日の午後向けエネルギー注入曲終盤のWell, Shake it, Shake it,Shake it, baby nowWell, Shake it, Shake it,Shake it, baby nowWell, Shake it, Shake it,Shake it, baby nowにロックンロールのカッコよさがほぼ詰まってるTwist And Shout - The Beatles https://t.co/q6RjG3LXc8",13,0,816,577,https://twitter.com/hi6yuky/status/1557935090831081472,13
1557908897637478400,NGY_it_anken,2022-08-12 01:56:40+00:00,8/12【Instagram更新】随時最新の案件情報を掲載しています💁‍♀️是非ご覧ください！https://t.co/7yOYLR6vis#Java #Python #C言語 #AWS #リモート #在宅ワーク #転職 #エンジニア転職 #駆け出しエンジニアと繋がりたい #企業公式相互フォロー #企業公式夏のフォロー祭り#SES営業#Twitter転職,15,2,572,581,https://twitter.com/NGY_it_anken/status/1557908897637478400,17
1557897291503403009,JS_TenshiDay,2022-08-12 01:10:33+00:00,令和3年8月から職業訓練校に通い、IT資格取得をしてきたのでそれらを紹介。令和3年7月 WEBクリエイター上級9月 ITパスポート令和4年3月 Java Programmer Silver7月 HTML5 Level1 ⇦New!!今後はHTML5レベル2の取得基本情報は来年から通年試験なのでその時#駆け出しエンジニアと繋がりたい,14,0,8,8,https://twitter.com/JS_TenshiDay/status/1557897291503403009,14
1557881354301616128,Java_suzume_,2022-08-12 00:07:13+00:00,換羽期の文鳥って、ちょっと凛々しい。#換羽期#文鳥 https://t.co/uCzFmXtiEh,22,0,78,301,https://twitter.com/Java_suzume_/status/1557881354301616128,22
1557860677179490304,kyooooonaka,2022-08-11 22:45:03+00:00,おはようございます！完全に休みの気分ですが、仕事頑張ります。今日からJavaの勉強して、手応えを見てからいつまでにJava silverを受験するか決めていこうかな。#プログラミング学習 #エンジニアと繋がりたい #Java,13,0,228,279,https://twitter.com/kyooooonaka/status/1557860677179490304,13
1557852139263004672,Shirakumolamp,2022-08-11 22:11:08+00:00,らんぷは9月の終わりまで激忙し期に入ってしまったので、配信はゲリラになるよ😭あんまり出来ないけど、してたら生きてるか〜？って生存確認しにきてね🦍Twitterはがんがん呟いて絡むつもりなのでよろしくです🙇‍♂️終わったらマイクラしたい...エペもしたい...Java版買うか迷うね...#おはようVtuber,10,0,102,114,https://twitter.com/Shirakumolamp/status/1557852139263004672,10
1557843449382318080,MitubaCraft,2022-08-11 21:36:36+00:00,ただいま帰省して夏休みを満喫中夜な夜なゲームはいつも通りですが…Java版のシェーダーを初めて使ってみたけど、このノートPCでは限界のようだ…お家に帰ったら、ハイスペックのPCの方で色々試してみようっと😆#Minecraft #マイクラ https://t.co/PUIJ6X7Qrn,32,1,734,538,https://twitter.com/MitubaCraft/status/1557843449382318080,33
1557839642069647360,fujimon76,2022-08-11 21:21:28+00:00,おはようございます。今日は曇り。蒸し暑いですね。昨日は祝日、久しぶりに子供達ものんびり。息子はマインクラフトから、パソコンとかプログラム言語に興味はあるみたい。昨日は話の流れでJavaとかC++の単語が出てきてびっくりしました。まだ単語知ってるだけのようですが、やり出したら面白いな〜。,10,1,638,201,https://twitter.com/fujimon76/status/1557839642069647360,11
1557835361803309056,yuki_web22,2022-08-11 21:04:28+00:00,「HTML &amp; CSS 学習レッスン 初級編」レッスンを修了しました！ https://t.co/lQq9JxsXDs #Progate 最後のページだけ答えを見てしまったけど、無料の初級編終了。Java Script の無料版お試しと、デイトラの無料講座の体験してみます。毎日勉強するの楽しい！！#プログラミング初心者と繋がりたい,10,0,22,9,https://twitter.com/yuki_web22/status/1557835361803309056,10
1557832916024975360,herumesulife,2022-08-11 20:54:44+00:00,おはようございます😊最近プログラミングを勉強し始めて、やっとHTMLとCSSのコードが書けるようになりました。✨最初は難しいいかなぁと感じたけど、実際やってみるとめっちゃ楽しい😊次は、javaスプリクト行っちゃいます😄#おは戦40811am #プログラミング初心者と繋がりたい,15,0,529,469,https://twitter.com/herumesulife/status/1557832916024975360,15
1557823165795299328,ryu_itkensa,2022-08-11 20:16:00+00:00,#朝活おはようございます☀[今日の学習]✔︎Java silver✔︎toeic AI問題Java silverの点数が伸びない…苦手分野を集中的に勉強します！今日も一日頑張っていきましょう📚,12,0,123,129,https://twitter.com/ryu_itkensa/status/1557823165795299328,12
1557787728380841984,Java_Meal2,2022-08-11 17:55:11+00:00,虎を回しまくるとバターになる,11,0,1538,443,https://twitter.com/Java_Meal2/status/1557787728380841984,11
1557760378108801024,null_0124,2022-08-11 16:06:30+00:00,競プロコンテストの問題文の言語が知りたくて「What languages are available in the contest?」を開いたら「C/C++/Java/Python」って書いてあった そう...,12,0,1266,1944,https://twitter.com/null_0124/status/1557760378108801024,12
1557753912694026240,lan_java,2022-08-11 15:40:49+00:00,【THE足軽Ver1.5.2】https://t.co/x1oqRAczztVerアップ版をたくあん（@TAQrinzAN）殿の林山文庫で配布します今回は「乱取りのさい、一人なのに仲間の会話が出る」という小さなバグ取りだけです。 https://t.co/PVKtP3HxIV,10,1,1480,760,https://twitter.com/lan_java/status/1557753912694026240,11
1557747662505791488,komi_nobu,2022-08-11 15:15:58+00:00,最初の投稿が遅くてすみません。ホームページ運用について、javaを介せず簡単に活動報告の投稿という技術的な課題をクリアするのに少し時間がかかってしまいました。また更新内容を簡単にSNSと共有できる環境を作ることを忘れており、0時を過ぎていますが友人と相談しながら試行錯誤してます(笑),12,0,125,130,https://twitter.com/komi_nobu/status/1557747662505791488,12
1557742098882764801,m_nxa6,2022-08-11 14:53:52+00:00,Java版のマイクラみんなどーやって買った？！？！,12,0,165,147,https://twitter.com/m_nxa6/status/1557742098882764801,12
1557738883671945219,goodnight_kuma,2022-08-11 14:41:05+00:00,17ヶ月記念配信遊びに来てくれて本当にありがと～っ🐻💖零ちゃんや銀音ちゃん、夏祭り会場を作ってくれた愛ちゃんと一緒に回れたのとっても楽しかったぁ✨14日から一般公開予定との事なので、JAVA版を持ってる子は一緒に遊ぼうねぇ🎶 https://t.co/yG09ay6vnd https://t.co/uNhtxcIXV3,12,3,644,304,https://twitter.com/goodnight_kuma/status/1557738883671945219,15
1557720235406692352,roolbackgramer,2022-08-11 13:26:59+00:00,保守に強い言語とはなんだろうか？C#やJavaだろう。この辺の言語は何十年たってもおおもとの仕様が変わらないため、何年も運用ができる。バージョンアップしてからのバグの検知もすぐ可能だ。 15   #駆け出しエンジニアと繋がりたい,10,0,202,2,https://twitter.com/roolbackgramer/status/1557720235406692352,10
1557718306991120384,mew2_op,2022-08-11 13:19:20+00:00,ちょっと！Javaさん、アチシ面白いこと言ったことない！！！！いつもクソ真面目だってばよーぅ！！！ https://t.co/EmP4vhHcAm,13,1,377,238,https://twitter.com/mew2_op/status/1557718306991120384,14
1557715605729738753,Java_Meal2,2022-08-11 13:08:36+00:00,耳が馬になっている妖怪と顔がTになっている怪人,13,1,1538,443,https://twitter.com/Java_Meal2/status/1557715605729738753,14
1557714570172858369,lazysonlazytaro,2022-08-11 13:04:29+00:00,java silverの12章やってみた。答えだけ覚えそうで怖い#駆け出しエンジニアとつながりたい#駆け出しエンジニアと繋がりたい #javasilver,17,0,2,5,https://twitter.com/lazysonlazytaro/status/1557714570172858369,17
1557713613817008128,yusuke_rea,2022-08-11 13:00:41+00:00,Java難しすぎ、、誰か隣について教えてほしい,11,0,1346,2533,https://twitter.com/yusuke_rea/status/1557713613817008128,11
1557712325381345280,TwSd501,2022-08-11 12:55:33+00:00,JSJavaとJavaScriptはメロンとメロンパンくらい違うらしいよ！#SUNABACO #やつしろ11th https://t.co/ZfwxMXFEQu,18,2,47,54,https://twitter.com/TwSd501/status/1557712325381345280,20
1557709801466933249,OOefcTXgMKDu3AR,2022-08-11 12:45:32+00:00,さ迷ってました！まぁ～山の日ことだし···海物語Java金富士打ってしまったのです。出るのか？出ないのか？分からんから仕方ない！！ https://t.co/gkadpay86y,11,0,1904,2001,https://twitter.com/OOefcTXgMKDu3AR/status/1557709801466933249,11
1557707025840492545,mari2908jp,2022-08-11 12:34:30+00:00,#大分市 は反対意見を無視して、寄贈を行うと回答してます。#高崎山の猿をウルグアイに送らないで#動物はモノじゃない@OitaCity_PR 反対意見をお送りください🙇‍♀️⬇️https://t.co/nZtKZvKKc3大分市、「寄贈を行う」とJAVAに回答　さらなる抗議を！https://t.co/DqL2ASC6IR,13,6,78,93,https://twitter.com/mari2908jp/status/1557707025840492545,19
1557702999224762368,mari2908jp,2022-08-11 12:18:30+00:00,#大分市 は野生のニホンザルを捕まえて、感染症のために6週間も個別檻に閉じ込めると回答してます。群れで家族と過ごすのに、まるで独居房。#高崎山の猿をウルグアイに送らないで#動物はモノじゃない@OitaCity_PR https://t.co/QeSg8hJABp,17,10,78,93,https://twitter.com/mari2908jp/status/1557702999224762368,27
1557701457839030273,phen0401,2022-08-11 12:12:22+00:00,ちなみにこんなのを書いてます👍コンソールの部分は自分の名前が書いてあるのでカットしました👌こんなツイートしたらタイ語関連のフォローワーが減るかな？😂#駆け出しエンジニアと繋がりたい #Java https://t.co/R5PII4DlLD,11,0,1501,355,https://twitter.com/phen0401/status/1557701457839030273,11
1557693317889986560,Le_UoxoU,2022-08-11 11:40:02+00:00,今からこちらを学習します！✨目標は60‐90分！・書籍 Java入門 ０～1章#プログラミング初心者 #駆け出しエンジニア,10,0,36,36,https://twitter.com/Le_UoxoU/status/1557693317889986560,10
1557687046780899328,Java_curry,2022-08-11 11:15:07+00:00,タキコおつかれ～～～ https://t.co/KDh4N5BjqF,10,0,432,544,https://twitter.com/Java_curry/status/1557687046780899328,10
1557674239712718849,web611544971,2022-08-11 10:24:13+00:00,【職業訓練校について】在学中は試験費用が半額になります！・Oracle認定Javaプログラマ・Ruby技術者認定試験制度（※職業訓練校によっては補助制度が違う可能性があるのであくまで参考でお願いします。）#プログラマー#プログラミング初学者と繋がりたい #駆け出しエンジニアと繋がりたい,31,1,1193,753,https://twitter.com/web611544971/status/1557674239712718849,32
1557661002124378113,tette,2022-08-11 09:31:37+00:00,Javaというか、ちゃんとしたアプリケーションの作り方を学び直したくて #プロになるJava を買ってみた #projava https://t.co/YczCn6hD0Q,11,3,781,813,https://twitter.com/tette/status/1557661002124378113,14
1557659714112335873,shiki_yo_naka,2022-08-11 09:26:30+00:00,よーし、ラストはPHPで締めてProgate復習に入る！💡（Ruby、Javaとかは難しそうだからやんない笑）と思いきやNode.jsにも関連記事が・・・しかも4つも笑一旦休憩して息子にご飯食べさせますかねー。息子、入院中ホント一日20時間ぐらい寝てる💤笑経過良好だからいいけど😅,21,0,218,287,https://twitter.com/shiki_yo_naka/status/1557659714112335873,21
1557658829923688448,lan_java,2022-08-11 09:22:59+00:00,ルカシェンコ「何がいいたいかといえば、この事件のせいでやっぱりウクライナに侵攻できないってことなんだよプーちゃん」プーチン「ストライキ、整備不良、計画の見直し…これで何回目のいいわけなんだ…？」 https://t.co/2gnsS3hOXY,15,4,1480,760,https://twitter.com/lan_java/status/1557658829923688448,19
1557652104969277441,Yabu_Minecraft,2022-08-11 08:56:16+00:00,Java版初の雑居ビル建てました。 #minecraft建築コミュ  #Minecraft #莎八辺市 #Minecraftbuilds https://t.co/1Avv1BZ6Ad,46,5,613,309,https://twitter.com/Yabu_Minecraft/status/1557652104969277441,51
1557928610803068928,Karasu_2036,2022-08-12 03:15:00+00:00,フォロワーを増やすための2つ条件①アルゴリズムに則って「いいね、コメント」をあなたから積極的に②有益な情報の発信①は画像の通り②はフォローされる理由です😠#ブログ #blog #ブログ初心者 #ブログ初心者と繋がりたい #ブログ仲間と繋がりたい #ブログ仲間募集中 #ブログ書け https://t.co/KdwTR2PtMm,15,0,1007,105,https://twitter.com/Karasu_2036/status/1557928610803068928,15
1557924845559627776,AxrossRecipe_SB,2022-08-12 03:00:02+00:00,「DRUNet」というディープラーニングを用いた画像のノイズ除去のアルゴリズムを学ぶレシピ。ディープラーニングによる画像のノイズ除去、画像回復アルゴリズム開発に活用できます。https://t.co/f78Owccuzr#AxrossRecipe#画像処理#プログラミング学習#駆け出しエンジニアと繋がりたい https://t.co/mNv6rd1zUS,15,0,1058,83,https://twitter.com/AxrossRecipe_SB/status/1557924845559627776,15
1557921404179296256,yamami_nishiki,2022-08-12 02:46:22+00:00,お休みの日のオフィス好き。賑やかなのもいいけど閑散としてるのも集中できていい。（ちょっと寂しいけど🤏）そんな私はTikTok動画作ってます。アラフォーでまさかTikTok作ることになるとは！バズるって何〜、、！？アルゴリズムも謎🫠リサーチして作って試行錯誤。Twitterもだけど常に挑戦だ！,22,0,486,344,https://twitter.com/yamami_nishiki/status/1557921404179296256,22
1557890926290567168,yHFHeFPssKzSlWL,2022-08-12 00:45:15+00:00,@arther456 Twitterの検索アルゴリズムより俺の食中毒の方がよく当たるよ〜,33,1,217,266,https://twitter.com/yHFHeFPssKzSlWL/status/1557890926290567168,34
1557880698496684032,cf_kaneiken,2022-08-12 00:04:37+00:00,研究の夢我々は光化学スモッグを予測する人工知能を開発しています。予測アルゴリズムは多変量データをディープラーニング、時系列予測。データ量も多いので、高性能GPUを積んだマシンが必要です！！8/18まで残り６日、ぜひご支援を！！https://t.co/vTf7vjPbwG#駆け出しエンジニアと繋がりたい https://t.co/2GBuRYXy6B,19,1,20,24,https://twitter.com/cf_kaneiken/status/1557880698496684032,20
1557859442397683712,jonyjohstar1118,2022-08-11 22:40:09+00:00,@arther456 アルゴリズムが死んだんじゃないの？w,16,2,1218,1224,https://twitter.com/jonyjohstar1118/status/1557859442397683712,18
1557778617446572032,sprflp,2022-08-11 17:18:59+00:00,興味を持ってくれる人が10人くらいしかいなそうな本ができました。Coppersmith法でCTFのCryptoの問題を解く本ではなく、Coppersmith法自体のアルゴリズムを解説する本です。コミックマーケット100と技術書典13で頒布します。CTFのCryptoで使うCoppersmith法を解説する本https://t.co/R0aDiukgdX https://t.co/kURNhB8KcE,57,13,83,1,https://twitter.com/sprflp/status/1557778617446572032,70
1557768797150273536,ako13LA,2022-08-11 16:39:57+00:00,1人で海外旅行する？(したことある？)ホラー映画は好き？この２つの答えが合ってるカップルは他の答えがバラバラでも長続きするそうです。アメリカのマッチングサイトのデータアルゴリズムの結論。,72,7,1428,428,https://twitter.com/ako13LA/status/1557768797150273536,79
1557753912891162624,tip1q,2022-08-11 15:40:49+00:00,計算じゃなくて、アルゴリズムの間違いしてた！2回目のforの時、0は最初の決まってる計算を事前にしてるからって初期値を1にしてたけど、デバッグしてよくよく考えたら0からじゃないと計算式合わなかった😌💭今日は放棄してた問題２つも解けた🥳#駆け出しエンジニアと繋がりたい#テックカレッジ https://t.co/geKP9KHo7L,29,0,755,654,https://twitter.com/tip1q/status/1557753912891162624,29
1557749336036937730,tsuba2392,2022-08-11 15:22:37+00:00,アルゴリズムの勉強するとき最近はこの本を参考に進めているけど凄くいい。今まではコードを読んで理解する方法で勉強してたけどやっぱり手を動かした方が遥かに理解が深まる。おすすめです。#駆け出しエンジニアと繋がりたい https://t.co/wNWBLvpRW9 https://t.co/PmRXbG93Ei,10,0,60,30,https://twitter.com/tsuba2392/status/1557749336036937730,10
1557744410271498240,oreo_writing,2022-08-11 15:03:03+00:00,／ おれおは🍪#おは戦40812ak＼今日は華金🥰一緒に認知度を上げていこうね🥰今日もここにリプしてみて。それからリプ欄全員に絡む。アルゴリズムに評価されればあなたの認知度は爆上がりだ。繋がって仲を深めていこうね。みんな最高の1日にしよう！置きリプ歓迎！『おはよ』だけでもOK,55,5,672,295,https://twitter.com/oreo_writing/status/1557744410271498240,60
1557736568269328387,trombone_su,2022-08-11 14:31:53+00:00,アルゴリズム体操じゃん https://t.co/pTXMkk1vOK,11,1,527,857,https://twitter.com/trombone_su/status/1557736568269328387,12
1557733187740385286,michellebat,2022-08-11 14:18:27+00:00,9月18日 東狂アルゴリズム25周年企画チケット予約は以下の受付フォームからお願いします。数に限りがありますのでお早めに！東狂アルゴリズム HPhttps://t.co/wQnEMNvm9U心斎橋ブロンズ HPhttps://t.co/qCxSymACr5 https://t.co/dI3LsexN1n,12,2,1059,828,https://twitter.com/michellebat/status/1557733187740385286,14
1557723266772774913,Algorithm_3,2022-08-11 13:39:02+00:00,アル呼びはかわいくて好きアルゴ呼びもゴルゴみたいで好きアルゴリラは強そうで好きアルゴリズム体操びっくりマークさん呼びは俺のこと舐めてんのか？,12,1,364,87,https://twitter.com/Algorithm_3/status/1557723266772774913,13
1557691249703784449,tokyoalgorithm,2022-08-11 11:31:49+00:00,この後21:00より結成二十五周年記念企画の🎫メール予約開始します。マジで来て欲しいので早めの予約お願いします。チケット予約受付サイト予約受付フォーム↓東狂アルゴリズムhttps://t.co/WmHqOrDX1T心斎橋ブロンズhttps://t.co/72jTC3uNfy https://t.co/NeITfRErfK,11,5,1809,258,https://twitter.com/tokyoalgorithm/status/1557691249703784449,16
1557691142128701443,CraneOfCopper,2022-08-11 11:31:23+00:00,定期的にアルゴリズムを語りたくなる欲が出てくる私です。アルゴリズムってシステム開発において必要な知識だし、日常においても思考の明確化になり色んな発想に繋がる。シンプルなようで奥が深いんですよ。まぁ、それをブログにしろよという話なんですけどね。,20,0,1484,1269,https://twitter.com/CraneOfCopper/status/1557691142128701443,20
1557689105571811330,arther456,2022-08-11 11:23:17+00:00,Twitterの検索アルゴリズムどうなってんだよ https://t.co/no81nMVYv3,26579,6248,1182,393,https://twitter.com/arther456/status/1557689105571811330,32827
1557681569657065473,yuiyui12322,2022-08-11 10:53:21+00:00,エンジニアは人によって数十倍生産性が違うって話、その人は常にアルゴリズムを考える等の職務だけを担当しているんだろうなぁ。仕事の半分を占める雑務で１０倍も生産性に差がつくはずないしね,31,4,1891,238,https://twitter.com/yuiyui12322/status/1557681569657065473,35
1557673693417197568,rikeisenjucanon,2022-08-11 10:22:03+00:00,Kaggle 姫「巡回セールスマン問題の厳密解を多項式時間で解けるアルゴリズムを持ってきなさい」,14,4,1577,4730,https://twitter.com/rikeisenjucanon/status/1557673693417197568,18
1557926862751408128,hpfull_01,2022-08-12 03:08:03+00:00,WordPressのローカル開発環境をDockerで構築する記事のソースコードを公開しました！Web制作の練習などに使えます！！記事: https://t.co/1iWw6dxNyMソースコード: リプへ！#駆け出しエンジニアと繋がりたい #web制作,11,0,812,751,https://twitter.com/hpfull_01/status/1557926862751408128,11
1557908804024832000,mrtc0,2022-08-12 01:56:18+00:00,“ソースコードから脆弱性を見つけよう” (1 user) https://t.co/dAKZDB6l1n,18,1,1543,885,https://twitter.com/mrtc0/status/1557908804024832000,19
1557782221461032960,kumakumaaaaa__,2022-08-11 17:33:18+00:00,とりあえずAHC013の環境揃えた・並列でテストケース実行ツール・保存ボタン押すとN個のテストケースの点数合計とソースコードを保存するツール・一応githubでも管理する（正直いらないかも？）,15,0,997,612,https://twitter.com/kumakumaaaaa__/status/1557782221461032960,15
1557654846257262592,yamasaki_aaaa,2022-08-11 09:07:09+00:00,人の書いたソースコードってすごく参考になる。PDFとかのところじゃないんですが、複数代入アクティビティの右辺って、IFを使った式書けるんですか…！？（みんなこれ当たり前に知ってることなのか…！？！？） https://t.co/cW1chfBB95,14,1,112,82,https://twitter.com/yamasaki_aaaa/status/1557654846257262592,15
1557629951087898624,key_public_,2022-08-11 07:28:14+00:00,酒飲んで徹夜ソースコードリーディング→ソースコードの内容何一つ覚えてない満身創痍の脳でセキスペ午後II解く→38/100点の大爆死を遂げるな に し て ん だ お ま え は,11,0,567,524,https://twitter.com/key_public_/status/1557629951087898624,11
1557581837807112193,pypy1225,2022-08-11 04:17:03+00:00,自社サービスは凄まじくレガシーなソースコードがお金生んでるのは知ってる？そんなにその遺物のお守りをしたいならご自由にどうぞ。個人的には少数精鋭のチームでスピード感のあるモダンな開発をぐるぐる回していくことが実力をつける近道な気がしてる。#駆け出しエンジニアと繋がりたい,32,1,593,597,https://twitter.com/pypy1225/status/1557581837807112193,33
1557559843556573184,titan3xFnfxte,2022-08-11 02:49:39+00:00,@h_masuoka ＞大抵のソフトウェアは既存技術AとBの結合が本質でありボトムアップ的に全く新規技術を実装するケースはレア＞・ソースコードは自然界のデータに比べて秩序立っているというか、プログラミング経験のない人の妄言か。全部間違い。「機械翻訳で、外国語は勉強しなくて良くなる」レベルの奴。,25,5,291,473,https://twitter.com/titan3xFnfxte/status/1557559843556573184,30
1557368881743728640,mca_be_official,2022-08-10 14:10:50+00:00,大変お待たせ致しました。MCAとTCMB間におけるソースコード流用疑惑に対し、報告書をまとめました。https://t.co/1r2mxSu4VJ,25,9,471,0,https://twitter.com/mca_be_official/status/1557368881743728640,34
1557350655290851330,chiakky_kudou,2022-08-10 12:58:25+00:00,今日は最近池袋にオープンした男のオムライスというお店に行ってきました( ˊ̱˂˃ˋ̱ )✨食欲は男並みともっぱら噂の私にはぴったりです😂QRコード読み取りして注文✨唐揚げ2倍オムライスにしました🤤卵はトロトロを、ソースはきのこクリームソース、ご飯300gをカスタマイズ✨めちゃうまでしたわぁ✨ https://t.co/GqLz6bAxwF,67,2,1325,1899,https://twitter.com/chiakky_kudou/status/1557350655290851330,69
1557313278732546049,gK876IXbdqvGVUK,2022-08-10 10:29:53+00:00,ヒプノシスマイクってもともと納品された時はどれも同じ形状なのよね？って考えてたらそうだ、マイクにある小さい針から血液サンプルを吸い取ってそのDNAに応じてマイクが形どられて、んでスイッチをONにしたら形状変化が始まるんだ！って妄想したソースコードがこちら。 https://t.co/kNujEDwNv7,555,91,108,166,https://twitter.com/gK876IXbdqvGVUK/status/1557313278732546049,646
1557292536007274496,chan_san_jp,2022-08-10 09:07:28+00:00,The Mergeトレード戦争に向けて鞘取りサヤちゃん公開しました🎉https://t.co/c9Lt2yD1jD最近個人的にハマっている Next.js × chakra × GitHub Pagesの静的サイト構成で配信しています（ソースコード公開しています）ゴールデンエッグ持ちの #MEGAMI もお迎えしたのであやかりたい#Ethereum,28,9,1220,414,https://twitter.com/chan_san_jp/status/1557292536007274496,37
1557275220414976000,minamip99,2022-08-10 07:58:39+00:00,ローバを復讐から解放するためにレヴが死ねるための何か（ソースコード？）の情報渡そうとしてると思うっていうさっきまでのツイートはこの掛け合いからです,15,0,1405,121,https://twitter.com/minamip99/status/1557275220414976000,15
1557263189024260096,minamip99,2022-08-10 07:10:51+00:00,いくら自分を解放しようとしての行動とは言え今原さんがレヴにソースコードとか情報を渡すなどの行動を起こそうとしたらヴァルロバの関係性いったんめちゃくちゃになるだろうけど、続,19,1,1405,121,https://twitter.com/minamip99/status/1557263189024260096,20
1557252936849166337,minamip99,2022-08-10 06:30:07+00:00,今原さんはレヴにソースコード渡そうと思ってるんじゃないかな～と思う　それをローバがどう捉えるかで今後が決まりそう,22,3,1405,121,https://twitter.com/minamip99/status/1557252936849166337,25
1557126737539895297,QuoteHaru,2022-08-09 22:08:38+00:00,プログラミングが上達するコツのひとつは他の人が書いた良質のコードを読むこと。「身近にそういう人がいない」という人はオープンソースのコードを読むと良いです😊難易度高めですが、勉強になるし、ある程度書けるようになった人にはおすすめです。#プログラミング,10,1,34,59,https://twitter.com/QuoteHaru/status/1557126737539895297,11
1557015895515742209,tomo555777,2022-08-09 14:48:12+00:00,■模写コーティング■参考サイト：Codestep6ッ目のサイトを模写開始。５ツ目のサイトのどうしても出来ないところは、デモサイトのソースコードを見て学習した。ほんとのほんとの最後の手段。#プログラミング初心者と繋がりたい #駆け出しエンジニアと繋がりたい#Web制作,32,0,604,734,https://twitter.com/tomo555777/status/1557015895515742209,32
1557935484025786368,oku_libito,2022-08-12 03:42:19+00:00,AWS認定ソリューションアーキテクトアソシエイト合格‼️‼️💮💯㊗️🎉結構頑張ったから…めっちゃ嬉しい〜😂😂😂😂 #AWS認定,25,0,1287,285,https://twitter.com/oku_libito/status/1557935484025786368,25
1557918923684585474,3yunomi_game,2022-08-12 02:36:30+00:00,やっとできたHello World!（スプラトゥーンみたいなゲームを作りたいと思った→マッチングするサーバ～が必要だよねぇ…→AWSでサーバーを作ろう→Node.jsでHello Worldを返すだけのプログラムをチュートリアルの通りにやってみたところです・・・） https://t.co/tyVZsd4WxU,12,0,1457,1862,https://twitter.com/3yunomi_game/status/1557918923684585474,12
1557908897637478400,NGY_it_anken,2022-08-12 01:56:40+00:00,8/12【Instagram更新】随時最新の案件情報を掲載しています💁‍♀️是非ご覧ください！https://t.co/7yOYLR6vis#Java #Python #C言語 #AWS #リモート #在宅ワーク #転職 #エンジニア転職 #駆け出しエンジニアと繋がりたい #企業公式相互フォロー #企業公式夏のフォロー祭り#SES営業#Twitter転職,15,2,572,581,https://twitter.com/NGY_it_anken/status/1557908897637478400,17
1557895393521766400,hibohiboo,2022-08-12 01:03:00+00:00,風船とびました。この一年、思い返すと色々ありました。AWS使ってツール公開ゲームブックツールLOST更新引っ越しなどなどまたこれからの一年、新しいことやっていきたいですね https://t.co/g9L8nYoJRx,34,0,1467,1162,https://twitter.com/hibohiboo/status/1557895393521766400,34
1557888888836096000,ashi_ssan,2022-08-12 00:37:09+00:00,激アツアップデートのブログを書きました。#DevelopersIO [アップデート] Amazon CognitoでAWS WAFが利用可能になりました https://t.co/IRxStvSq17,37,10,406,409,https://twitter.com/ashi_ssan/status/1557888888836096000,47
1557883633935200261,npnmk250,2022-08-12 00:16:17+00:00,@ZizzREF 最近awsの資格の勉強をしてますが、awsも物凄く優れたサービスだけど、あくまで「顧客のビジネスを効率良くする」だけで、ビジネス自体を生み出すわけではないんですよね。AIも機械学習もデータサイエンスも同じで、あくまで人間のやりたいことを実現するためのサポートツールでしかないというか。,13,7,167,1241,https://twitter.com/npnmk250/status/1557883633935200261,20
1557882109091774464,fu3ak1,2022-08-12 00:10:13+00:00,CognitoさんAWS WAFに対応https://t.co/p7szNIwJXW,13,2,902,196,https://twitter.com/fu3ak1/status/1557882109091774464,15
1557878256551964673,oku_libito,2022-08-11 23:54:54+00:00,AWS SAA試験緊張‼️全力で挑むのみ‼️,23,0,1287,285,https://twitter.com/oku_libito/status/1557878256551964673,23
1557877030200688640,Yukahehn,2022-08-11 23:50:02+00:00,ライジング　サン震えるぐれいステキ💕なフェスやん。風くんが出る出ない関係なく。いつか参加したいなあ。明け方のBEGIN😍最高やん💕29時て何時よ😱腹巻いるんちゃう？@FujiiKaze #24時半スタート#まつり踊るんか？@Vaundy_AWS #コロニャン#早く治してね,45,0,1049,1254,https://twitter.com/Yukahehn/status/1557877030200688640,45
1557866888981782528,joe_us_stock,2022-08-11 23:09:44+00:00,$AMZN Amazon 業績予想(22.12月期)と今後の見通し22年4-6月期の売上高は前年同期比7%増で市場予想を上回った。営業利益は同57%減で市場予想を上回った。ネット通販の売上高は同4%減と3四半期連続減となったが、AWSの売上高は同33% 増と好調。売上高の2桁成長期待が株価の支援材料になる可能性。 https://t.co/O4RDRdZQcI,13,0,1350,388,https://twitter.com/joe_us_stock/status/1557866888981782528,13
1557853860286177281,string_tatsuya,2022-08-11 22:17:58+00:00,おはようございます！折角の夏休みなのでAWS Cloud Questをやってます！無料でAWS触れてリソースの削除とかしなくて済むから嬉しい！実務経験が多少あるおかけで、基本英語でもなんとかなる☺️TOEICで200点を切った僕でも…笑,12,0,918,264,https://twitter.com/string_tatsuya/status/1557853860286177281,12
1557839785368383488,aws_TakS07,2022-08-11 21:22:02+00:00,おはようございます。今日は1年4ヶ月ぶりのフィリピンに行ってきます🇵🇭第2の故郷😂フライトは夕方なので、ルビコン塾の復習とジムに行ってこよう。,18,0,945,294,https://twitter.com/aws_TakS07/status/1557839785368383488,18
1557743951443922951,site_webmaster,2022-08-11 15:01:14+00:00,@site_webmaster【試験区分】AWS認定資格 CLF（クラウドプラクティショナー）【第50問】 データ保管ポリシー正解は「ア」です。解説はこちら↓https://t.co/bQkHDOKeus#駆け出しエンジニアと繋がりたい#プログラミング初心者#インフラエンジニア,10,0,54,65,https://twitter.com/site_webmaster/status/1557743951443922951,10
1557734723312848898,tanar_tanar,2022-08-11 14:24:34+00:00,今日は京都は琴引浜で海水浴して、天橋立の絶景を眺めてきました(・∀・)今から早速AWS SAPの学習を進めていきます！リフレッシュしつつ、地道に勉強です(・∀・)#AWS #駆け出しエンジニアと繋がりたい  #駆け出しエンジニアとつながりたい https://t.co/XlHvH6i5dh,19,1,420,567,https://twitter.com/tanar_tanar/status/1557734723312848898,20
1557727658502283264,PANDA_KENJ1,2022-08-11 13:56:29+00:00,海浜🐬 陽浜☀️Happy Birthday🎉12th Anniversary❤️#アドベンチャーワールド🐼@aws_official ・誰にも止められない！！大暴れ陽浜☀️▶️https://t.co/Vsh2YzfU1B▶️ https://t.co/HQxpkV3oaW,45,4,1153,258,https://twitter.com/PANDA_KENJ1/status/1557727658502283264,49
1557714088159223808,BBQsosh,2022-08-11 13:02:34+00:00,さっきAWS -SAAの試験で合格できて、嬉しい☺️正式な結果通知は5日後みたい。,11,0,14,30,https://twitter.com/BBQsosh/status/1557714088159223808,11
1557709595120123904,tmokmss,2022-08-11 12:44:42+00:00,CDKの複数スタック並列デプロイ、次でくるな僕は最近シングルスタック構成ばかりだから、しばらく恩恵受けられなさそうだ…https://t.co/K1iaAo0vj1,12,2,136,121,https://twitter.com/tmokmss/status/1557709595120123904,14
1557707449712316418,55kepin,2022-08-11 12:36:11+00:00,隆浜と秋浜　AWS 2004 https://t.co/h65KmrYfe4,36,3,1053,12,https://twitter.com/55kepin/status/1557707449712316418,39
1557705280125009922,HEHN_kaze221,2022-08-11 12:27:34+00:00,@Vaundy_AWS 代打は”藤井風”におまかせあれ！！ばうくんはゆっくり休んで下さい🙏🏼／#RISINGSUNROCKFESTIVAL2022🔥✨#Vaundy ✨✨#藤井風  #FujiiKaze ✨　健康第一💪ココロも身体も健やかに🙏🏼＼,14,0,51,86,https://twitter.com/HEHN_kaze221/status/1557705280125009922,14
1557699699733581824,et5jsGuVWHNx9Y9,2022-08-11 12:05:23+00:00,@aws_official 彩ちゃん❤️1番小さく生まれて、すごく心配しましたが、スタッフさんたちのお世話で、社長🌈にまでなって🤣🤣スタッフさんたちの飼育力素晴らしいですね💕💕もうすぐお祝いですね👍私の甥っ子も8/14生まれです。ダブル誕生日🙌🙌💕💕,11,0,59,93,https://twitter.com/et5jsGuVWHNx9Y9/status/1557699699733581824,11
1557678383164960768,anonymous158532,2022-08-11 10:40:41+00:00,#駆け出しエンジニアと繋がりたい #プログラミング初心者と繋がりたい #プログラミング勉強中フォローやアドバイスありがとうございます！追いついてなくてすみません...とりあえずawsのアカウント作って色々勉強中です！プログラミング言語はgolang気になります,48,0,72,46,https://twitter.com/anonymous158532/status/1557678383164960768,48
1557676982430642176,Fujimiya_Yutaka,2022-08-11 10:35:07+00:00,AWS SAAに合格しました！スコアは747とギリギリ。。クラウドプラクティショナーの受験から１か月も経たずに受験したけど、何とかなるものですね。Udemyの講座のおかげかな。#Udemy#AWS認定 https://t.co/V8Iyy2lpqq,12,0,5,26,https://twitter.com/Fujimiya_Yutaka/status/1557676982430642176,12
1557665065863499781,eroiore0707,2022-08-11 09:47:46+00:00,勝負師なので4連休の初日にAWS認定試験ぶっこんで華麗に勝ちました。あとは寝るか飲むだけ。,11,0,84,154,https://twitter.com/eroiore0707/status/1557665065863499781,11
1557661957133840384,next_innove,2022-08-11 09:35:25+00:00,awsのデプロイができません。#AWS #駆け出しエンジニアと繋がりたい,27,0,83,37,https://twitter.com/next_innove/status/1557661957133840384,27
1557644863805730816,cloud_945,2022-08-11 08:27:29+00:00,AWS SAA合格した◎実務経験ないけど、基礎少し身についたかな、、！#AWS,73,0,217,108,https://twitter.com/cloud_945/status/1557644863805730816,73
1557643253888929794,hayanohako,2022-08-11 08:21:05+00:00,@aws_official 先日ペロペロしあってた2頭🐈🐈かな？終わったと思ったらまた始まる笑,13,0,18,18,https://twitter.com/hayanohako/status/1557643253888929794,13
1557639896122003456,nagatoyukyon,2022-08-11 08:07:45+00:00,とりあえずAWS SAAは合格しました結構ギリギリな気がする,12,0,322,395,https://twitter.com/nagatoyukyon/status/1557639896122003456,12
1557622143151927296,kasacchiful,2022-08-11 06:57:12+00:00,AWS認定Solutions Architect - Professionalに合格した。期限切れる前に更新できて良かった。,69,1,627,651,https://twitter.com/kasacchiful/status/1557622143151927296,70
1557860666408673280,noriyukitakei,2022-08-11 22:45:01+00:00,【毎日発信のオススメ技術書籍Tweet】Gitを学ぶ上でこれ以上にわかりやすい本はないかと思います。コミットやプッシュの概念からプルリクの内容まで学べます。 しかもマンガなのでとっつきやすい！！https://t.co/5pyjkHuao6 #駆け出しエンジニアと繋がりたい #プログラミング,14,0,1069,436,https://twitter.com/noriyukitakei/status/1557860666408673280,14
1557859255075872768,ayu_littlewing,2022-08-11 22:39:24+00:00,ちなみにこのときは何故かgitからチェックアウトするときに日本語を含むPathにしたせいで『your module location contains non-ASCII characters』と思いっきりエラー出てるのに『原因不明のエラーです!!』と大騒ぎしてた(;;;・_・)原因超明確に書いてあるやん。。。,28,2,1677,2673,https://twitter.com/ayu_littlewing/status/1557859255075872768,30
1557858145942130688,takiasahi,2022-08-11 22:35:00+00:00,#今日の予定✅業務✅Git学習今日もお仕事と学習、両方できるといいな。まず子供たちを図書館に連れて行って暇つぶしの本をいろいろ借りてくるというのはどうだろう？小さい頃は素直に図書館でもどこでも行ったのですが、最近は文句が出るんだよな～😅#tatdd,20,0,1890,1856,https://twitter.com/takiasahi/status/1557858145942130688,20
1557849348712857600,suzuki_py,2022-08-11 22:00:02+00:00,Qiitaで #Git に関する投稿を定期的に漁ってます！#プログラミング#プログラミング初心者#駆け出しエンジニアと繋がりたい特別な理由なしにgit-flowを新規採用するべきではないhttps://t.co/zEdjdgBewM,12,0,494,311,https://twitter.com/suzuki_py/status/1557849348712857600,12
1557835515050700800,pinguo_engineer,2022-08-11 21:05:04+00:00,おはようございます☺HTML &amp; CSS課題のヘッダー部分をうまく作れずモヤモヤ😭そんな難しくないはずなのにできなくて泣けます。最初から完璧目指さず、質問してみようかな…🍎Day 72#昨日の積み上げ・HTML &amp; CSS・Git計10h22m#ポテパンキャンプ 4#プログラミング#100DaysOfCode#朝活,11,3,64,55,https://twitter.com/pinguo_engineer/status/1557835515050700800,14
1557784609576075264,ayustudy_games,2022-08-11 17:42:47+00:00,@poo03221397 分散型バージョン管理のGitが全くわからない人は、そもそも集中型バージョン管理のSVNが理解出来ていないので、急がば回れでSVNから学習する方がいいと思ってます。#テックアイエス#プログラミング勉強中#プログラミング初心者#駆け出しエンジニアと繋がりたい#フリーランスになりたい,19,0,329,252,https://twitter.com/ayustudy_games/status/1557784609576075264,19
1557748624674947073,takiasahi,2022-08-11 15:19:48+00:00,#日誌✅業務✅Git学習学習とお仕事両方できた✨よくよく考えたら制作会社様との業務委託が始まってから学習したのは初めてでは！(ウェビナー除く)業務で使うと思ったら今までに無い集中力でした。今まではなんだかんだ言って「使わないから適当で」と思ってたのかも😅#tatdd,15,0,1890,1856,https://twitter.com/takiasahi/status/1557748624674947073,15
1557708873615953920,kosukein38,2022-08-11 12:41:50+00:00,"本日の学習終了！Git, GitHubの復習、Lintチェック（RuboCop）、Railsアプリへフラッシュメッセージ、デコレーターを実装しました。✔︎やったこと:Rails実践(基礎)課題7までtoday: 8hr (total: 158hr)#RUNTEQ #1000時間チャレンジ",11,0,79,91,https://twitter.com/kosukein38/status/1557708873615953920,11
1557705337943523328,ruckplus,2022-08-11 12:27:47+00:00,本日の勉強会は、以下の３点について行いました🎊・勉強する目的の再認識（スキルシートを作成する）・勉強会の方針（毎週木曜20:00-21:00）・Git復習未経験エンジニアを半年で現場で稼働できるように育成していきます😇#駆け出しエンジニアと繋がりたい #駆け出しエンジニア,12,0,167,183,https://twitter.com/ruckplus/status/1557705337943523328,12
1557621724128038913,v9938,2022-08-11 06:55:32+00:00,BEEPさんからの販売告知出ました。今回は、2スロット拡張基板とそれ向けのシェルケース、MEGA-SCC(似非SCC) SST Flash版のキットになります。MEGA-SCCのGitは若干内容古いので更新していないと、、、 https://t.co/wIoeTB9xOZ,19,7,1307,638,https://twitter.com/v9938/status/1557621724128038913,26
1557610741406273537,fukumaru_story,2022-08-11 06:11:54+00:00,"🐬現所有スキル🐬🍀HTML/CSS(Sass)🍀JavaScript(jQuery)🍀PHP/DB🍀Git/GitHub🍀AdobeXD,Photoshop🍀Googleアドセンス合格済↓「おやつカロリーチェック機能付き」架空のドーナツ屋さんサイトを作ってみました🍩おなかが気になる方はぜひ遊んでみてください😁https://t.co/Wz2hJ3ebbt",14,0,305,225,https://twitter.com/fukumaru_story/status/1557610741406273537,14
1557583692436246530,poo03221397,2022-08-11 04:24:25+00:00,Gitが全然理解できない😂何回読んでも意味わからん😂#テックアイエス#プログラミング勉強中#プログラミング初心者#駆け出しエンジニアと繋がりたい#フリーランスになりたい,45,0,48,8,https://twitter.com/poo03221397/status/1557583692436246530,45
1557562455189889024,suzuki_py,2022-08-11 03:00:02+00:00,Qiitaで #Git に関する投稿を定期的に漁ってます！#プログラミング#プログラミング初心者#駆け出しエンジニアと繋がりたいGitコマンド / VSCode上でのブランチ操作https://t.co/6K2Yec57Ha,19,0,494,311,https://twitter.com/suzuki_py/status/1557562455189889024,19
1557515939520073728,mokunone,2022-08-10 23:55:11+00:00,「Git 学習レッスン I」レッスンを修了しました！Gitの基礎を勉強しました！使えるようになったら、共同でプログラムを作成できるのですね😆 https://t.co/z3KzUlYSPZ #Progate #RUNTEQ #1000時間チャレンジ,12,0,1558,2034,https://twitter.com/mokunone/status/1557515939520073728,12
1557498282116616194,noriyukitakei,2022-08-10 22:45:02+00:00,【毎日発信のオススメ技術書籍Tweet】Gitを学ぶ上でこれ以上にわかりやすい本はないかと思います。コミットやプッシュの概念からプルリクの内容まで学べます。 しかもマンガなのでとっつきやすい！！https://t.co/5pyjkHuao6 #駆け出しエンジニアと繋がりたい #プログラミング,10,0,1069,436,https://twitter.com/noriyukitakei/status/1557498282116616194,10
1557495768373755904,takiasahi,2022-08-10 22:35:02+00:00,#今日の予定✅子供達とお出かけ✅業務✅git学習昨日は学習できなかったんでした🥲やはり夏休みは難しい。10分とか細切れの時間はあるんですよね。でも10分だと思い出すだけで終わっちゃう。今日は時間をうまく使えますように❗#tatdd,16,0,1890,1856,https://twitter.com/takiasahi/status/1557495768373755904,16
1557460050943561728,git_iger,2022-08-10 20:13:07+00:00,"マスター2人をクラッチわーーい#PS5Share, #ApexLegends https://t.co/LlroYzdqQI",10,0,369,360,https://twitter.com/git_iger/status/1557460050943561728,10
1557374760283095041,git_iger,2022-08-10 14:34:12+00:00,"初ハンマーやったあああああああああああああああああああああああああああ#PS5Share, #ApexLegends https://t.co/wDs4RGgp1y",15,0,369,360,https://twitter.com/git_iger/status/1557374760283095041,15
1557372647691800576,massy_zer0,2022-08-10 14:25:48+00:00,ひっさしぶりにreact触ったら良くわからんバグ大量発生してた...node_modules入れ直してエラー消えたけど何だったんだ...てか、node＿modules消せなくて困ってたけどgit bashで解決！（vscodeのターミナルもcmdからbashに変えるか迷う）,12,0,544,557,https://twitter.com/massy_zer0/status/1557372647691800576,12
1557367540413739010,aki_2ag,2022-08-10 14:05:30+00:00,辛口だけど、駆け出しに現実を叩きつけると、教材と現場は違う。教材を活かして、自分で家庭環境をSOHOレベルまで上げて、Git管理DB設計、Zabbix監視出来てスタートライン#駆け出しエンジニア  　#駆け出しエンジニアと繋がりたい　#プログラミング初心者　#プログラミング初心者と繋がりたい,18,0,179,499,https://twitter.com/aki_2ag/status/1557367540413739010,18
1557341454149636096,ooooonse0524,2022-08-10 12:21:51+00:00,■8月10日学習時間：1H・RUNTEQ課題（Rails実践基礎5 途中）■8月11日(目標)・RUNTEQ課題（Rails実践基礎5）・Everyday Rails（8章）・Git知識整理やっちまった！！😇#RUNTEQ  #1000時間チャレンジ,27,0,155,137,https://twitter.com/ooooonse0524/status/1557341454149636096,27
1557339861543055361,handlename20,2022-08-10 12:15:31+00:00,本日の成果。冥成長、ノーナ＋4。外史トークン報酬は回収完了。明日からは人喰い沼周回に移ります。黄金塊がいっぱい落ちてGitが少し潤いました。そろそろ装備品の強化をしないとですね… https://t.co/QCFFojBFeo,40,0,737,867,https://twitter.com/handlename20/status/1557339861543055361,40
1557336203653160961,R_O_R_I_J_O,2022-08-10 12:00:59+00:00,gitの使い方がわからないんですが、作り方を学習すれば使い方もわかりますか？,15,4,1950,365,https://twitter.com/R_O_R_I_J_O/status/1557336203653160961,19
1557317080646488064,s_murakami29,2022-08-10 10:45:00+00:00,ターミナルでGitやDockerなどのコマンドを繰り返し打っている人は、今すぐエイリアスを設定しましょう。設定ファイルに「alias gb='git branch'」みたいに書くだけでめちゃくちゃ効率上がります。ぜひ。https://t.co/mcn3E6X6t6#web制作#プログラミング初心者 #駆け出しエンジニアと繋がりたい,25,0,1133,794,https://twitter.com/s_murakami29/status/1557317080646488064,25
1557293905464688640,oz_i9m,2022-08-10 09:12:54+00:00,1週間前はGitとGitHubの違いすらよう分かってなかったのに、クローンしてブランチ切ってプルリクエスト出すまで今日1人でできて成長感じた涙涙,261,4,217,308,https://twitter.com/oz_i9m/status/1557293905464688640,265
1557260387556306946,zou1138,2022-08-10 06:59:43+00:00,昨日の勉強会の課題をやり終えて、Gitに貼ってFreeksに連絡した。Java講座第三章のHTML&amp;CSSは課題のレイアウトが、まだ今のところ、うまく出来ない。＃駆け出しエンジニアと繋がりたい＃プログラミング#Freeks進捗,15,0,120,246,https://twitter.com/zou1138/status/1557260387556306946,15
1557209819727409152,mota_2021web,2022-08-10 03:38:47+00:00,今日の朝活♾制作会社営業♾ブログ準備♾Git学習ブログのデザイン弄るだけでも慣れてないと大変ですね😅早く記事を書いていきたい💦制作会社の方と話した上でGitは必要だなと感じたので改めて学習します‼️よく話を聞くわかばちゃん買ってみました😌#デイトラ #web制作 #朝活 https://t.co/1p9RuMqefN,12,0,130,70,https://twitter.com/mota_2021web/status/1557209819727409152,12
1557208879288778754,takiasahi,2022-08-10 03:35:03+00:00,お仕事でGitを使うので勉強しようと思ってます。素直に「業務で使ったことはありません」と言ってもいいのですが(最初の面談で言ったかもしれないけど)、ここで「分かってますよ～」風にしたいがために一生懸命学習するのもいいかなと思ってます。ま、実際はできるもできないも言わないでおきます😁,29,0,1890,1856,https://twitter.com/takiasahi/status/1557208879288778754,29
1557186073843093504,otoiron,2022-08-10 02:04:25+00:00,gitは私の中で勉強しておいて損がなかったことの上位に入ります。リモート、副業で面識のない人、新規取引先の会社とやり取りする際にgithubでやり取りすることが多く、会話がとてもスムーズになります。,12,0,576,464,https://twitter.com/otoiron/status/1557186073843093504,12
1557179822022877184,FX_SysTradeEA,2022-08-10 01:39:35+00:00,３回に分けてMT4/5でGitを活用する基本を整理しました。第1回Git活用　Gitインストール https://t.co/mR0L9ZcHsh,12,2,917,785,https://twitter.com/FX_SysTradeEA/status/1557179822022877184,14
1557133370374533120,takiasahi,2022-08-09 22:35:00+00:00,#今日の予定✅業務×1✅お出かけ✅Git学習今日は子供たちとお出かけの予定です。お仕事は夜にやる予定。でも学習もしたい。果たして時間はあるのか！？という感じです。何とか時間をやりくりします。#tatdd,15,0,1890,1856,https://twitter.com/takiasahi/status/1557133370374533120,15
1557030235220373504,takiasahi,2022-08-09 15:45:10+00:00,#日誌✅業務×2これからお盆の時期なので少し業務が少なめです。今のうちに子供たちとお出かけします！そして先日学んだGitを使う機会がやってきました。怪しいので学びなおさなければ！あとは英語。もちろんDeepLに頼りますがやはり直接読み書きした方が早い。とにかく慣れなければ！#tatdd,16,0,1890,1856,https://twitter.com/takiasahi/status/1557030235220373504,16
1557028225204625408,faunsu19000,2022-08-09 15:37:11+00:00,git が苦手な人に捧ぐ https://t.co/IuHrGJRLXN,15,3,472,99,https://twitter.com/faunsu19000/status/1557028225204625408,18
1557938173061251076,yamaaaa_03,2022-08-12 03:53:00+00:00,これまでフリーランスになるためにがむしゃらに行動してきましたが、6割くらいイケるって思ったことには勇気を出して飛び込んできました。それで今なんとかなってます！これからもエイヤッ！の精神でチャレンジ精神を忘れず進んでいきます！その一歩を踏み出せるかどうかで未来は変わります！,10,0,827,280,https://twitter.com/yamaaaa_03/status/1557938173061251076,10
1557934968395169793,kaimu__inaka,2022-08-12 03:40:16+00:00,体調管理本当に大事だー！コロナもですが体調管理気をつけましょう🥺今日は上がってきたデザインのレビューをするぞー！面白い事も企画中#山梨 #フリーランス #クリエイター #自営業 #地域創生 #課題解決 #webデザイナー #駆け出しエンジニアと繋がりたい #田舎コミュニティ,11,0,69,114,https://twitter.com/kaimu__inaka/status/1557934968395169793,11
1557929186157031424,smem_risweb,2022-08-12 03:17:17+00:00,大企業に勤めてる友だちがフリーランスになろうとしてて一緒に仕事したりしてるんだけど「仕様が固まって降りてくると思うな」「決まってないと文句言うなら提案しろ」「まっすぐな道以外にも方法はある」っていうことを全然理解してくれない…フリーランスってまずはそこからな気がする,13,0,1233,202,https://twitter.com/smem_risweb/status/1557929186157031424,13
1557926596983459840,hina_hiyoko,2022-08-12 03:07:00+00:00,今日は朝からイラストAのラフを描いて送付。取材記事Bの構成を考えながら別の記事Cの修正が入れば対応しつつまた別のイラストラフDのOKがでたら彩色。日々いくつもの仕事が同時進行。常に優先順位を考えながら進めます。#イラスト #ライター #Webライター #フリーランス  #クリエイター https://t.co/aXv4S6aRUa,35,0,1772,1054,https://twitter.com/hina_hiyoko/status/1557926596983459840,35
1557923828554145792,Marsa_Ltd,2022-08-12 02:56:00+00:00,ちょうど1年前本業やめてフリーランスになしました。突然「会社辞めて日本に遊びに行こう！」と思ってしまったから・・・。１０年務めてたけど、ニュージーランドには退職金はありません🤣１年あっという間！,13,0,581,237,https://twitter.com/Marsa_Ltd/status/1557923828554145792,13
1557920053907148800,ShareHairSalon1,2022-08-12 02:41:00+00:00,フリーランス美容師のための面貸しシェアサロン◆売上70％を還元！川越駅・本川越駅からすぐの綺麗な2店舗独立したい方はお気軽にお問い合わせください♪https://t.co/RgCRfzC7zj#川越 #本川越 #美容師 #シェアサロン #面貸し #フリーランス美容師 #川越駅 #本川越駅 #企業公式相互フォロー https://t.co/gW8AyNqIOZ,11,1,170,380,https://twitter.com/ShareHairSalon1/status/1557920053907148800,12
1557913010043179008,chinatsu_n123,2022-08-12 02:13:00+00:00,今日は子宮頸がん検診を受けてきました😊毎年忘れてても当たり前のように会社から連絡が来る女性検診、健康診断！とても有難いことだとしみじみ感じました！！フリーランスになったら誰も教えてくれない。。健康あってこその仕事！遊び！！💪 #web制作 #webデザイン #レッツ朝活サロン,14,0,357,260,https://twitter.com/chinatsu_n123/status/1557913010043179008,14
1557907277407199232,mono_tukamu,2022-08-12 01:50:14+00:00,五苓散も飲むか～。今日は、あかんわ。あんまりにも酷かったら、仕事は休みにする。〆切まで余裕はあるし、ダメな日に頑張っても修正作業が増えるだけ。＃フリーランス,16,0,533,541,https://twitter.com/mono_tukamu/status/1557907277407199232,16
1557905962551615488,Webshofree,2022-08-12 01:45:00+00:00,今日は最低でも構成を10本仕上げないといけないので、全力で頑張ります！🔥Webライターになってからカフェや自宅に引き籠ることが多くなってきているので、季節が感じられなくなってきています笑#webライターと繋がりたい#Webライター#フリーランス #フリーランスと繋がりたい,19,0,928,140,https://twitter.com/Webshofree/status/1557905962551615488,19
1557904273274535936,hon_komyusyo,2022-08-12 01:38:17+00:00,ある悩みを抱える人が目の前にいて…あなたはそれを解決する商品を持っている。こんな条件が揃ったらセールスしたくなりませんか？何なら「セールスしないと！」くらいに思いませんか？逆にこの条件が揃ってないと、そりゃ売るのに抵抗ありますよね。#ビジネス#フリーランス#マーケティング,10,1,1478,797,https://twitter.com/hon_komyusyo/status/1557904273274535936,11
1557901436456816640,god48_,2022-08-12 01:27:01+00:00,さすがに暑いのでオフィス用の卓上扇風機買いました‼️暑がりなので年中、使っていきます‼️笑もちろん家では使わないので、常駐先に持っていきます！笑🤣#駆け出しエンジニアと繋がりたい #プログラミング初学者 #フリーランス,13,0,240,37,https://twitter.com/god48_/status/1557901436456816640,13
1557900315772735489,429_omochi,2022-08-12 01:22:34+00:00,わたし去年仕事辞めてへんたら、ザストからしっかり追うことも無かったんやなぁと思った。仕事辞めてよかった☺️そして今ののんびりフリーランスに変えてよかった！！時間に余裕がある！そして結婚したから金にも心にも余裕ができた！最高〜！,18,0,238,232,https://twitter.com/429_omochi/status/1557900315772735489,18
1557897089761550336,moamoa30,2022-08-12 01:09:45+00:00,さて今日もがんばりますか!#動画編集者と繋がりたい #動画編集#フリーランス,21,0,164,142,https://twitter.com/moamoa30/status/1557897089761550336,21
1557894987379245057,horisanchu,2022-08-12 01:01:23+00:00,フリーランスなど立場の弱い事業者に課税を半強制するインボイス制度益税益税というが消費税法は「消費税を販売価格に上乗せしなければならない」とは一言もなく任意であり必ずしも「益税」が発生する仕組みではない。判例も消費税は価格の一部としている#インボイス制度の実施に反対する,13,8,499,558,https://twitter.com/horisanchu/status/1557894987379245057,21
1557893046460637184,i_like_ruby,2022-08-12 00:53:41+00:00,#プログラミング初心者 の方は、どのような人物がメンターをしているのか気になると思います。僕はうつ病になって独学でフリーランスになりました。稼げるまでの道のりをリアルに書いた、僕の自己紹介記事を貼っておきます。#駆け出しエンジニアと繋がりたいhttps://t.co/5SL64p58Ad,20,0,450,110,https://twitter.com/i_like_ruby/status/1557893046460637184,20
1557891089096667136,Maiko_m921,2022-08-12 00:45:54+00:00,「自由に働きたい」とフリーランスを希望する人は多い。でも自由ってめっちゃ曖昧じゃん？目標は明確であればあるほど達成できる確率が上がるんだよね。自分にとっての「自由」とは具体的に何が叶う状態なのか、言語化できるようになろう！あなたにとっての答えはあなたの中にしかないのだ。 https://t.co/7fXoQkk5ma,15,1,1674,1444,https://twitter.com/Maiko_m921/status/1557891089096667136,16
1557890870996881410,tenshokustories,2022-08-12 00:45:02+00:00,／副業したい・フリーランスになりたい主婦・ママ必見！＼女性向けのおすすめプログラミングスクール5選！✍️https://t.co/jbViu5NmBQ#WithCode#副業#フリーランス#プログラミングスクール#プログラミング初心者#プログラミング未経験#新人エンジニア#駆け出しエンジニアと繋がりたい,21,0,1086,2752,https://twitter.com/tenshokustories/status/1557890870996881410,21
1557890024800419843,zabutonletter,2022-08-12 00:41:40+00:00,頭で「めんどくさい」って感じることって実際やるとそうでもないです。頭で考えてるときってやること全体を描いてしまい、ボリュームに圧倒されてしまいがち。でも実際は小さなタスクをコツコツこなすだけです。やれば「なんだ楽勝じゃん」と感じられるはず！まず行動命🔥#フリーランス#webデザイン,14,1,313,313,https://twitter.com/zabutonletter/status/1557890024800419843,15
1557889750714830849,nao19mi,2022-08-12 00:40:35+00:00,フリーランスは一つ一つの仕事が命綱。だけどそれに囚われすぎて合わない仕事をやると疲弊する。そこを見極めていくのが良い未来へ繋がるのかも。#WEBライター#webライターと繋がりたい#フリーランス,15,0,1912,2271,https://twitter.com/nao19mi/status/1557889750714830849,15
1557889347860455424,yutoyolonyc,2022-08-12 00:38:59+00:00,学生さんやフリーランスの方でプログラミング頑張っている方と繋がりたいです！どなたでも大歓迎です！自分と繋がったらすごいメリットがあるかもです。#駆け出しエンジニアと繋がりたい #プログラミング初学者と繋がりたい #Progate #Web制作,19,0,1154,1823,https://twitter.com/yutoyolonyc/status/1557889347860455424,19
1557884796847550464,Vol7ch300,2022-08-12 00:20:54+00:00,ありがたいことに取引先からお声掛けを頂いて来週からフリーランスをやめて正規雇用で働くことになりました！色々と条件面でも折り合いつけて頂いたし、凄く情熱のある相手と巡り会えたと思うのでまたここから頑張っていきたいと思います。,10,0,127,718,https://twitter.com/Vol7ch300/status/1557884796847550464,10
1557882979833106433,manaco_kt,2022-08-12 00:13:41+00:00,世間はお盆休み🍉ですが、我が家は通常運転の日に設定👐フリーランスはもちろん自分次第だし、最近は一般企業でもお盆休みなし、各自有休で夏休みをとるスタイルも増えているようですね😙来週は少し休むので、今日はキッチリ集中したいところ👀🔥,12,0,132,138,https://twitter.com/manaco_kt/status/1557882979833106433,12
1557881636309856256,nobu_nobu99,2022-08-12 00:08:20+00:00,美容室を開業する方の歳が若くなってきてる。25歳で開業をする。美容師の働き方も雇用型、業務委託、シェアサロンのフリーランス、独立開業幅広くなった。自分の人生を自分で決めていくこと大切。👇美容室開業チャンネルhttps://t.co/CdozYSiXoo https://t.co/yuAOyldpDq,12,0,504,213,https://twitter.com/nobu_nobu99/status/1557881636309856256,12
1557878071826321409,DDG732_hiei,2022-08-11 23:54:10+00:00,初代KATO製品を塗り替えただけでなく、手すりを別パーツ化しリアルなフリーランス車両になっています。いろいろな部分でお手本になる作品で勉強になります。(´ω｀) https://t.co/Bm5EhE4hkY,10,1,790,272,https://twitter.com/DDG732_hiei/status/1557878071826321409,11
1557876953428144128,freedashman,2022-08-11 23:49:44+00:00,フリーランスである程度稼げてきたら、働かなくても稼げる仕組み作りへ。今まで労働力や時間を献上することで得ていたお金から、勝手にお金が生み出される非労働型のビジネスを作る。資産運用をし、商品を作り、商流をつくり、勝手に売れる仕組みを作ろう。,19,1,484,553,https://twitter.com/freedashman/status/1557876953428144128,20
1557875799382175745,Nichijo_Kanato,2022-08-11 23:45:09+00:00,残り44日。淡路島以来約2ヶ月ぶりに家族でドライブ行ってきます！何かほんまにゆっくり過ごせてるなー…それが、こんなにも嬉しい事だなんて休みが毎週決まってある頃は分からなかったよ。フリーランス一直線だな。。では、よき休日を！！#おは戦40812ak #家族 #ドライブ,17,0,66,49,https://twitter.com/Nichijo_Kanato/status/1557875799382175745,17
1557933236072095744,collabo_style,2022-08-12 03:33:23+00:00,THE ANSWERさまに、元Jリーガーで現在弊社で開発をしている内村のセカンドキャリアについてインタビューをしていただきました。セカンドキャリアを切り拓く姿をぜひご覧ください！引退→ITエンジニア転職は「逆に面白い」　J1札幌元エース、今歩む前例なき第二の人生https://t.co/LV85kucLVT,98,52,160,62,https://twitter.com/collabo_style/status/1557933236072095744,150
1557921144120160257,satoryo0929,2022-08-12 02:45:20+00:00,引退→ITエンジニア転職は「逆に面白い」　J1札幌元エース、今歩む前例なき第二の人生（THE ANSWER） https://t.co/GESxDHk6cI,12,4,901,643,https://twitter.com/satoryo0929/status/1557921144120160257,16
1557884187574734849,hikari0net,2022-08-12 00:18:29+00:00,Webエンジニアに未経験就職、転職したい方におすすめの専門エージェントをプロフィールでまとめてます#ITエンジニア #エンジニア転職 #駆け出しエンジニアと繋がりたい自分自身が既卒フリーターからWeb業界飛び込んだけどエージェント選びが一番重要だと感じた,14,1,891,374,https://twitter.com/hikari0net/status/1557884187574734849,15
1557884135187808256,gUm77GuM,2022-08-12 00:18:16+00:00,プログラミングスクール付きの転職エージェント利用してITエンジニアになれた元フリーターです自分が使って良かったところやそのほか未経験から出IT業界転職に特化してるエージェントについてﾌﾟﾛﾌで解説してるので参考に#駆け出しエンジニアと繋がりたい,10,0,414,388,https://twitter.com/gUm77GuM/status/1557884135187808256,10
1557862995866226690,ton09876286,2022-08-11 22:54:16+00:00,IT WEB エンジニア向け人気転職サイト「2022最新　3選」おすすめ事業会社で社内SE務めてきた40代の転職が増えてきました。https://t.co/s8lNFovOq6#プログラミング初心者 #エンジニア転職 #駆け出しエンジニアと繋がりたい https://t.co/7YJYFL21gg,14,0,1516,4924,https://twitter.com/ton09876286/status/1557862995866226690,14
1557851344806940674,oyomechan_fight,2022-08-11 22:07:58+00:00,実は昨日モチベめっちゃ下がる事があったんだけど、旦那さんにこんな事あったよって言ったら…「エンジニアになるの難しいって言うけどさ、そんなん他の仕事も一緒じゃない？」不安だったけど、大丈夫になりました。ありがとう。 #エンジニア  #プログラミング  #駆け出しエンジニア #転職,15,0,410,394,https://twitter.com/oyomechan_fight/status/1557851344806940674,15
1557829463345221632,ton09876286,2022-08-11 20:41:01+00:00,IT WEB エンジニア向け人気転職サイト「2022最新　3選」おすすめhttps://t.co/s8lNFovOq6#プログラミング初心者 #エンジニア転職 #駆け出しエンジニアと繋がりたい https://t.co/G7D4no4E4l,18,0,1516,4924,https://twitter.com/ton09876286/status/1557829463345221632,18
1557829201981427712,ton09876286,2022-08-11 20:39:59+00:00,時流はエンジニアです比較した転職サイトで収入アップおすすめhttps://t.co/2pcJYgYJ2V#プログラミング初心者 #エンジニア転職 #駆け出しエンジニアと繋がりたい https://t.co/hORV29jGyc,15,0,1516,4924,https://twitter.com/ton09876286/status/1557829201981427712,15
1557799540119707649,tip1t,2022-08-11 18:42:07+00:00,駆け出しエンジニアは「まず就職して勤務実績を作る」がめちゃくちゃ大事です。その際に「次の転職の足掛かりになる業務を選ぶ」が欠かせない。つまり❶安い給料でも❷多少ブラックでも❸魅力的な仕事を任されることが❹確実な内定、を勝ち取ることが大事。贅沢は敵。 #駆け出しエンジニアと繋がりたい,47,2,281,8,https://twitter.com/tip1t/status/1557799540119707649,49
1557744794419740672,the_engeniir,2022-08-11 15:04:35+00:00,WEBエンジニアの給料が高めなので未経験転職を目指す人多いけど、タイパを考えればそう高給でもないと思う。勉強する時間を確保というより、空いてる時間は全て勉強に使う。受験のときみたいな勉強をずっとし続ける感じ。嫌じゃないけど😏 #駆け出しエンジニアと繋がりたい,77,1,46,146,https://twitter.com/the_engeniir/status/1557744794419740672,78
1557743839523340294,tomo_ITBizBlog,2022-08-11 15:00:47+00:00,【📢運用保守で働く方もそうでない方も】24365運用保守のオペレーターのエンジニアだった僕がITの会社でインフラエンジニアに転職した経験談を書きました。https://t.co/CTTb4UM2kW#IT土方 #駆け出しエンジニアと繋がりたい#エンジニア #SE #転職活動 #転職エージェント 13,10,0,1523,1217,https://twitter.com/tomo_ITBizBlog/status/1557743839523340294,10
1557738172070907904,abechan_front,2022-08-11 14:38:16+00:00,相手の立場に立って考えるということはとても大切。エンジニア転職で例えると自分が〇〇をしたいだけでは不十分でなぜその会社は実務未経験者でも雇いたいと考えるのか、相手の立場に立ってどういう人物が求められているのか考えられる人は転職がうまくいく。#駆け出しエンジニアと繋がりたい,13,0,426,143,https://twitter.com/abechan_front/status/1557738172070907904,13
1557721009087987713,saya_alacarte,2022-08-11 13:30:04+00:00,転職のためにプログラミング勉強するなか一時食事できないほどに胃が痛くてコンソールを見たくない症候群に陥ってた。知人のエンジニアに勉強法とか聞いて話してたら今日はプログラムを理解するのが楽しくなった。人と話するの大事。#駆け出しエンジニアと繋がりたい,10,0,8,6,https://twitter.com/saya_alacarte/status/1557721009087987713,10
1557716978701254656,ton09876286,2022-08-11 13:14:03+00:00,IT WEB エンジニア向け人気転職サイト「2022最新　3選」おすすめhttps://t.co/s8lNFovOq6#プログラミング初心者 #エンジニア転職 #駆け出しエンジニアと繋がりたい https://t.co/CMx4tLbrdl,17,0,1516,4924,https://twitter.com/ton09876286/status/1557716978701254656,17
1557716811965030400,ton09876286,2022-08-11 13:13:23+00:00,時流はエンジニアです比較した転職サイトで収入アップおすすめhttps://t.co/2pcJYgYJ2V#プログラミング初心者 #エンジニア転職 #駆け出しエンジニアと繋がりたい https://t.co/nbuqX8mcBs,19,0,1516,4924,https://twitter.com/ton09876286/status/1557716811965030400,19
1557665375705214976,Yurie_dev,2022-08-11 09:49:00+00:00,◆ 私の転職事情・応募したのは5社程・HPのフォームから直接アタックした会社に就職・ちなみに募集はしてなかった・面接は無く、面談というラフな感じ未経験だと、熱意や意欲も結構大事😌#web制作 #プログラミング初心者 #駆け出しエンジニアと繋がりたい #エンジニア,42,0,94,4,https://twitter.com/Yurie_dev/status/1557665375705214976,42
1557590586265202688,ton09876286,2022-08-11 04:51:49+00:00,時流はエンジニアです比較した転職サイトで収入アップおすすめhttps://t.co/2pcJYgYJ2V#プログラミング初心者 #エンジニア転職 #駆け出しエンジニアと繋がりたい https://t.co/zF040zhwuD,20,0,1516,4924,https://twitter.com/ton09876286/status/1557590586265202688,20
1557590403695579136,ton09876286,2022-08-11 04:51:05+00:00,IT WEB エンジニア向け人気転職サイト「2022最新　3選」おすすめhttps://t.co/s8lNFovOq6#プログラミング初心者 #エンジニア転職 #駆け出しエンジニアと繋がりたい https://t.co/yirss5Ms7D,15,0,1516,4924,https://twitter.com/ton09876286/status/1557590403695579136,15
1557580557617627136,xxxo5o2yy,2022-08-11 04:11:58+00:00,20代の元アパレル販売です☺️転職中で現在WEBエンジニア目指すために活動してますꪔ̤̮頑張ってる方、同じ境遇として仲良くしてください🥰 #駆け出しエンジニアと繋がりたい#エンジニア#転職活動,46,0,30,150,https://twitter.com/xxxo5o2yy/status/1557580557617627136,46
1557563307439128576,hikari0net,2022-08-11 03:03:25+00:00,ITエンジニアへの未経験転職を目指す方へのおすすめエージェントをプロフィールでまとめてます！実際使って今現役です#エンジニア転職 #未経験エンジニア #駆け出しエンジニアと繋がりたい,11,0,891,374,https://twitter.com/hikari0net/status/1557563307439128576,11
1557563283582111745,hayasakadaichi,2022-08-11 03:03:19+00:00,実務未経験からエンジニアに転職して、6ヶ月経ちましたが、何とかなってます。最初の3ヶ月は大変でしたが、今ではクライアントと連絡を取り合い、GitHubに issueを作り、ガシガシReactで開発してます。当然まだまだ未熟ですが、エンジニアとして仕事ができてます。#駆け出しエンジニアと繋がりたい,20,0,550,145,https://twitter.com/hayasakadaichi/status/1557563283582111745,20
1557531846438789121,roro2l,2022-08-11 00:58:24+00:00,Webエンジニア転職したいけどスキルないのでスクールで学びたい方向けにWebエンジニア特化のプログラミングスクールをプロフに貼ってます私が未経験からWebエンジニアになれたのはスクールで学び、企業紹介でWebエンジニアその後もスキルアップ転職経験者です#駆け出しエンジニアと繋がりたい,20,0,67,28,https://twitter.com/roro2l/status/1557531846438789121,20
1557517888491139072,kimu_tg,2022-08-11 00:02:56+00:00,トゥモローゲートって営業の会社ってイメージが強くてエンジニアがいる印象が薄いんですよね。僕も入社前にトゥモローゲートがエンジニア募集してるの見てビックリしました。転職考えてるエンジニアの方はホームページ見て是非検討してみてほしいです。https://t.co/eVyyV280D2,31,2,1004,200,https://twitter.com/kimu_tg/status/1557517888491139072,33
1557462543483822080,ton09876286,2022-08-10 20:23:01+00:00,複数のIT転職エージェントに登録、面談に参加し、自分に紹介可能な求人案件内容の確認がおすすめです。IT WEB エンジニア向け人気転職サイト「2022最新　3選」おすすめhttps://t.co/s8lNFovOq6#プログラミング初心者 #エンジニア転職 #駆け出しエンジニアと繋がりたい https://t.co/NVamHr0dxi,15,0,1516,4924,https://twitter.com/ton09876286/status/1557462543483822080,15
1557462055497580549,ton09876286,2022-08-10 20:21:04+00:00,無料なので複数登録して問い合わせメールを送りチャンスを逃さないのが時流時流はエンジニアです比較した転職サイトで収入アップおすすめhttps://t.co/2pcJYgYJ2V#プログラミング初心者 #エンジニア転職 #駆け出しエンジニアと繋がりたい https://t.co/1qaw1jTOxo,17,0,1516,4924,https://twitter.com/ton09876286/status/1557462055497580549,17
1557392892590956544,doumoosewani,2022-08-10 15:46:15+00:00,スタートアップで経験積みたいっていってメルカリに転職したエンジニア、もうメルカリはスタートアップではありません。,43,1,1986,73,https://twitter.com/doumoosewani/status/1557392892590956544,44
1557351217449566209,busshidayo,2022-08-10 13:00:39+00:00,27歳でエンジニアになろうとしたけど、書類選考で半分以上がお断り理由を尋ねると、この年齢でエンジニア未経験の方は必要ないとのことだった今日が1番若いのだから行動しようただ、27歳でも転職できることは自分が証明しているので、なりたい人は頑張ればなれる＃駆け出しエンジニアと繋がりたい,53,1,73,39,https://twitter.com/busshidayo/status/1557351217449566209,54
1557348988990345219,yokubaribambids,2022-08-10 12:51:47+00:00,AIエンジニアになりたい方へこちらマストの内容だと思います！実際に私の転職活動ではここで書かれているような知識を2/5社から聞かれました。機械学習がメインの会社は必ず聞いてくるのでぜひ押さえておくとよいです😊 https://t.co/hyiPioyGFJ,13,1,1694,249,https://twitter.com/yokubaribambids/status/1557348988990345219,14
1557319169825157121,ton09876286,2022-08-10 10:53:18+00:00,時流はエンジニアです比較した転職サイトで収入アップおすすめhttps://t.co/2pcJYgYJ2V#プログラミング初心者 #エンジニア転職 #駆け出しエンジニアと繋がりたい https://t.co/w8bsrAtBjN,15,0,1516,4924,https://twitter.com/ton09876286/status/1557319169825157121,15
1557318996776456192,ton09876286,2022-08-10 10:52:37+00:00,IT WEB エンジニア向け人気転職サイト「2022最新　3選」おすすめhttps://t.co/s8lNFovOq6#プログラミング初心者 #エンジニア転職 #駆け出しエンジニアと繋がりたい https://t.co/Wbawg33N0M,14,0,1516,4924,https://twitter.com/ton09876286/status/1557318996776456192,14
1557310640154628096,YukihiroLaravel,2022-08-10 10:19:24+00:00,嬉しい報告が！☺️昨年教えていた元受講生と久々に話したたら、モダンで自由な会社に10月から転職するらしい❗️✅フルフレックスタイム✅リモートor出社選択自由✅Laravel/React数ヶ月前まで残業続きで辛そうだったけど転職・独立すれば急に待遇改善することがあるからエンジニアは夢がある✨,16,2,1990,402,https://twitter.com/YukihiroLaravel/status/1557310640154628096,18
1557310425964122112,moshiti2,2022-08-10 10:18:33+00:00,10月からエンジニア転職決まりました！✨✨転職といっても営業からエンジニアに社内転職するんですが（笑）まずは見習いからスタートです！給料も1.7倍🥺︎💕頑張るぞ〜💪( ˙꒳​˙💪),18,0,82,127,https://twitter.com/moshiti2/status/1557310425964122112,18
1557293601679241217,ton09876286,2022-08-10 09:11:42+00:00,時流はエンジニアです比較した転職サイトで収入アップおすすめhttps://t.co/2pcJYgYJ2Vとにかく面倒見がよく親切なところを選ぼう！無料なので登録は多いほうがチャンスがある#プログラミング初心者 #エンジニア転職 #駆け出しエンジニアと繋がりたい https://t.co/1KIjdg04YU,14,0,1516,4924,https://twitter.com/ton09876286/status/1557293601679241217,14
1557246980623339520,Ma_Matsuzaki,2022-08-10 06:06:27+00:00,エンジニアへ転職を考えている方達はお見逃しなく😳#エンジニア転職#未経験エンジニア＃ENたま#駆け出しエンジニアと繋がりたい https://t.co/IlF2oD8N4b,19,1,726,677,https://twitter.com/Ma_Matsuzaki/status/1557246980623339520,20
1557245482514219011,JAC_Omura,2022-08-10 06:00:29+00:00,これまで全業界の事業会社のIT職種を担当してきて感じるけど、企業によってITエンジニアに対する見方はさまざま。スキル重視で判断する企業もあれば、大卒必須、転職回数は1回までといったような「履歴書の綺麗さ」重視で判断する企業もある。昨今は後者だと採用に苦戦するケースが増えている。,11,0,169,148,https://twitter.com/JAC_Omura/status/1557245482514219011,11
1557935100125642753,934bQHcUM1G1NEL,2022-08-12 03:40:47+00:00,感覚がおかしいのは言わずもがな、気に入らない統計を否定するための根拠が「飽きるだろ」な時点で終わっとるオタクたちの「そうだそうだ！子供はそんなにゲームなんてやってない！ゲームを悪者にするな！」って反応を期待してたなら浅薄としか言いようがない https://t.co/F3zjq8B9aF,19,9,1178,969,https://twitter.com/934bQHcUM1G1NEL/status/1557935100125642753,28
1557934522666078212,share_JJ,2022-08-12 03:38:29+00:00,YouTube設定確認。国を日本にして統計情報をオン←オフになっている場合が多々あるとのことです。少しのことだけど重要事項#TraceTrace #KingandPrince,26,20,448,200,https://twitter.com/share_JJ/status/1557934522666078212,46
1557929470828621824,miuratakuyajp,2022-08-12 03:18:25+00:00,相変わらず「糖質制限で痩せたけど、やめたら太った」って人が沢山いますが、ダイエットやめたら太るよ😓世の中の統計的にダイエットで痩せた人の80%がリバウンドする傾向があるみたいですが、80%全員が糖質制限なわけない💦って考えたらカロリー制限でもやめたら太るんよね。,10,0,1657,518,https://twitter.com/miuratakuyajp/status/1557929470828621824,10
1557926594504577024,monakatoankook,2022-08-12 03:06:59+00:00,ドル円は、毎日が雇用統計。,12,0,369,82,https://twitter.com/monakatoankook/status/1557926594504577024,12
1557916145490878464,MIEforever,2022-08-12 02:25:28+00:00,リツイートさせていただきます。日本には、していたけど‥統計情報がオフになってたぁ〜💦 https://t.co/SDgFS0WQ6m,13,8,259,515,https://twitter.com/MIEforever/status/1557916145490878464,21
1557909122263048194,kanman740,2022-08-12 01:57:33+00:00,ひょっとしたら、4回目はシェディング専用の枠💉ではないのか?又、アタオカ言われそうだけど昨日のス─パーや今朝の犬の散歩ですれ違うクルマからの匂いから明らかに4回目と解ってしまう!具体的な統計を採った訳ではないがツイでも脱走するイヌネコが3回目より多く感じる。べ─スの化学物質の匂いが↓,54,16,1475,743,https://twitter.com/kanman740/status/1557909122263048194,70
1557904031573774336,h61TGpryI3CffMG,2022-08-12 01:37:20+00:00,乗り気がしない時はのんびりまとめを見るーー、、、って、うっかり眺めてると何もする時間がなくなるので白書統計動画見よかな（そんなこと言うてる暇ないやろと言う皆様、その通りなんです😅）#シャロ勉合宿 #癒しの時間 https://t.co/8Sfp2vhE8D,15,0,493,445,https://twitter.com/h61TGpryI3CffMG/status/1557904031573774336,15
1557900933853773824,ShTokyot,2022-08-12 01:25:01+00:00,【台湾・オミクロン株】12歳以下の重症・死亡は計159人、そのうちMIS-Cが90人、脳炎27人、肺炎21人。死亡27人。https://t.co/a1hPE3CEb05月末の統計で12歳以下の感染率は5.84%。10歳以下の死亡率は10万分の5、世界平均を上回る。https://t.co/4qIRJvgi8W,19,19,1747,1298,https://twitter.com/ShTokyot/status/1557900933853773824,38
1557897837794340865,CfjOSsfvU2yJU7A,2022-08-12 01:12:43+00:00,米国で食品価格高騰が裏付けられた。7月のCPIで食品価格は前年同月比＋10.9%1979年以来の43年ぶりの大きさでシリアルやスープは統計市場最大の伸びを記録した。エネルギー価格下落を主因にCPI全体では市場予想を下回った。しかし食品価格の急騰は家賃や住宅ローン金利高と同様に消費者を苦しめそうだ。,16,0,1010,211,https://twitter.com/CfjOSsfvU2yJU7A/status/1557897837794340865,16
1557897110124519424,yakiginnan13,2022-08-12 01:09:50+00:00,日本人労働者の給与は統計が示す通り、このジリ貧の一途を辿っているし、肌感覚でも実感している…俺は身を削る仕事に就いている事もあり同世代の平均年収は超えているが、一方で父と母の現役時代の年収に及ばない…退職金に至っては、父母の半額程度だと思う… https://t.co/iUCWy44WKc,12,2,1414,1392,https://twitter.com/yakiginnan13/status/1557897110124519424,14
1557894564916396032,CPR78865430,2022-08-12 00:59:43+00:00,欧米コロナ感染者数は少なくカウントされている英国の実際の感染者数は、公式感染者数の15倍が実態また英国の陽性者公式統計は、5月から更新されていない米国の実際の感染者数は公式統計数の31倍スコット氏は「感染者数が10万人なら、実際は100万人以上だろう」と述べた。https://t.co/KQTIlucdBm,13,2,546,597,https://twitter.com/CPR78865430/status/1557894564916396032,15
1557885710945751040,oopswd1,2022-08-12 00:24:32+00:00,夏休みもこうして勉強していますが、中国語や関西圏で言う所の「勉強」はしていません。私は学ぶ事が好きですが、インプットしてアウトプットするのが好きなのだと思います。来期から本科生になるので、まだ履修登録が出来ず💦はやく成績出てー！と願ってます。来期はこの教科と、統計学を取ります,11,0,201,231,https://twitter.com/oopswd1/status/1557885710945751040,11
1557876349821685760,penginsan392,2022-08-11 23:47:20+00:00,#シャロ勉合宿 前夜祭皆さんのツイ見てると泣けてきそう😭前回試験から一年、様々な思いを秘めて残りの時間がんばり抜きましょう❗️🌸大目標、社労士試験合格  全科目、何を覚えてて何を覚えていないかを把握怪しいものを中心に固める毎日判例、統計、条文、助成金成し遂げます‼️✨,59,1,488,352,https://twitter.com/penginsan392/status/1557876349821685760,60
1557873115761614848,yuchi_lions,2022-08-11 23:34:29+00:00,やっぱり私が高校野球よりプロ野球の方が好きなのって同じ相手と何度も戦うことにおける統計学の有用性なんだろうなぁってデータまとめたノート見ながら思う,22,0,514,397,https://twitter.com/yuchi_lions/status/1557873115761614848,22
1557871267164090368,RirahoRiraho,2022-08-11 23:27:08+00:00,おはようございます☀5:30起床朝活は、ガイダンス確率統計　P10まで。Ａ ∩ Ｂのとこなので、ここまで厳密に考えた事がなかったので、ほほーってなりました。頭の中でベン図を描く訓練にもなった。(複雑なのはノートに…)今のところとても楽しい😆✨ワイのいいところは証明が好きなとこやな〜,26,1,1319,639,https://twitter.com/RirahoRiraho/status/1557871267164090368,27
1557871001920499712,chris_bakken131,2022-08-11 23:26:05+00:00,ここ2ヶ月ちょいの相手別勝率🧮（22万位上のみフレマ対象）Aフォメ:63勝25敗Bフォメ:364勝146敗Cフォメ:87勝19敗Fフォメ:44勝28敗ステータスバランスやその他は割愛🤫こうやって統計取るとB相手でかなり落としている🤔何でも集計取ると色々見えてきて楽しいですね🤤#Bのガチ勢が1番怖い😨,29,0,1189,1097,https://twitter.com/chris_bakken131/status/1557871001920499712,29
1557868012191219712,t_kajiyakushiro,2022-08-11 23:14:12+00:00,#釧路#ひやみかち首里城#イマソラ8月12日 8:00 21.0℃雨です午後には止む予報コロ陽性者が累計で1500万人になったとか…私の職場の同フロアーにいるのは13人で、コロナ陽性経験者が2人だいたい統計と同じ陽性者の確率さ～今日もコロナ負けずに乗りきっていきましょーね https://t.co/ox1IE1LXEw,12,0,305,336,https://twitter.com/t_kajiyakushiro/status/1557868012191219712,12
1557865072545828864,ahikicoin,2022-08-11 23:02:31+00:00,【#Symbol Node List】統計情報の表示仕様を変更。過去30日分のノード情報を表示していましたが、毎月1日の情報を統計取得開始時点(2021/11)に遡って表示するように変更しています。ノード数の増減が、過去に遡ってわかるようになりました。https://t.co/CMq1QQH11F#XYM https://t.co/ViG7xhoPsb,20,8,1259,333,https://twitter.com/ahikicoin/status/1557865072545828864,28
1557860958063960064,Aruckychi,2022-08-11 22:46:10+00:00,おはようございます！夜中に愛犬に2回ほど起こされてしまい、今朝は寝坊しました…😅積み上げが減ってしまうのは痛いですが、愛犬が元気なので良しとします🙌【朝活】統計：33min新聞今日もよい1日を！#朝活 #プログラミング初心者 #駆け出しエンジニア,15,0,297,201,https://twitter.com/Aruckychi/status/1557860958063960064,15
1557936791088668672,the_engeniir,2022-08-12 03:47:30+00:00,@nakamurarrr2011 ですね。。ときどきがっかりします。とはいえ個人としてはなんとかしなきゃなので、『情熱プログラマー』（オーム社）の4章「マーケティング…スーツ族だけのものじゃない」とかを読みながら自分の技能をどうマーケティングしていくかを試行錯誤しています。 #駆け出しエンジニアと繋がりたい,10,0,46,146,https://twitter.com/the_engeniir/status/1557936791088668672,10
1557918810354487296,hiroki_wakamoto,2022-08-12 02:36:03+00:00,@Hobbyshopsora これ、ホントにそうだと思います。知人からＨＰ制作の依頼を受けて、友人のプログラマーに紹介したら、割引して引き受けてくれたんですけど、その後知人と話したらとても不満で……。その上ケンカ腰で「お前らパソコンちょいちょいいじるだけやないか」と言われました。その後すぐ絶交しました。,38,11,380,806,https://twitter.com/hiroki_wakamoto/status/1557918810354487296,49
1557889307414827014,TakabotGo,2022-08-12 00:38:49+00:00,大学生プログラマーがテックキャンプの無料カウンセリングに参加してみた感想！https://t.co/ElInARDfSS#プログラミング学習#プログラミング初心者#プログラミング,10,0,163,123,https://twitter.com/TakabotGo/status/1557889307414827014,10
1557850406046162945,i_like_ruby,2022-08-11 22:04:14+00:00,服装に自信がない #プログラマー 必見！#エンジニア 向けブランド！#プログラミング#プログラミング学習#プログラミング初心者#プログラミング初学者#駆け出しエンジニアと繋がりたい#駆け出しエンジニアとつながりたい#プログラミング初心者と繋がりたい#SUZURIhttps://t.co/EMoY6fUXJf,17,1,450,110,https://twitter.com/i_like_ruby/status/1557850406046162945,18
1557849659669852160,ryujinji0120,2022-08-11 22:01:16+00:00,これらはウソ。プログラマーは「パソコンに向かってるだけの仕事」「ヒトと話さない」「個人プレーで仕事完遂」って思ってる人が多すぎる。実際には周りのメンバーと綿密にコミュニケーション取りながら仕事を進める。個人技に走る人へはお勧めしない。システムを作っているのは血の通った人間なのです,9,2,131,145,https://twitter.com/ryujinji0120/status/1557849659669852160,11
1557774800843866112,hanzawa108,2022-08-11 17:03:49+00:00,~動画編集ソフト開発進捗~BGM挿入機能実装サウンドファイルの音声波形をサムネイル化#動画編集者と繋がりたい #動画編集 #プログラミング #プログラマー #Python https://t.co/dWzlcEL0aK,15,0,200,188,https://twitter.com/hanzawa108/status/1557774800843866112,15
1557726041212260355,01ACT3,2022-08-11 13:50:04+00:00,18歳になったら、ゲームプログラマーに就いて、イラストレーターやりながら、歌&amp;ゲーム実況でYouTube始めます笑(できるのか)絶対、YouTubeは始めます笑,28,2,1141,495,https://twitter.com/01ACT3/status/1557726041212260355,30
1557725017781063682,NAMAKO__COMPASS,2022-08-11 13:46:00+00:00,@fate_prototypeB 戦乙女のプログラマー水浴び中に服を隠される↓嫁に行くのフローチャート作った段階で6徹くらいしてるだろ。休め。んでもうちょい頑張ってくれ。,36,2,582,1231,https://twitter.com/NAMAKO__COMPASS/status/1557725017781063682,38
1557716188737990656,nagisa7654321,2022-08-11 13:10:55+00:00,プログラマー職(エンジニア)に就こうと思って色々作ってきたけど未経験で年齢もアラフォー。厳しいのは分かってたけど方向転換しないとけないのかなと思います。せめて Excel VBA を活かしていけたら幸いと考えてます。#駆け出しエンジニアと繋がりたい https://t.co/wO6CEf0BIn,14,0,107,206,https://twitter.com/nagisa7654321/status/1557716188737990656,14
1557710031172251648,tenkeshi_sosaku,2022-08-11 12:46:26+00:00,カビフェス感想その8(ラスト)30thという文字通り、音で歴史をぶつける感覚はすんばらしかった😭しかしもちろんデザイナーやプログラマーなど曲以外の方々のお力で今があることも忘れないように、常に製作者全員に感謝しながら今後も楽しませていただきたい所存です本日はありがとうございました✨ https://t.co/iZmLEcRmkK,15,1,506,414,https://twitter.com/tenkeshi_sosaku/status/1557710031172251648,16
1557702082295001093,okmariko,2022-08-11 12:14:51+00:00,将来ゲームプログラマーになりたいと言う息子(小5)に、良質なインプットをと思い買い与えたミニファミコン。もう3年くらい経つのに、「くにおくんの熱血大運動会」が特にお気に入りで、2か月に1回くらい家族大会が開催される。やはり昔のゲームは色褪せない。#ミニファミコン#くにおくん #りき派 https://t.co/BY7Q1r1XxO,15,0,188,168,https://twitter.com/okmariko/status/1557702082295001093,15
1557683301464567808,Sonsaww,2022-08-11 11:00:14+00:00,プロのプログラマーになるための「地図」を提供してくれる。初心者向けの学習方法はもちろん、仕事の見つけ方についても広く浅く書かれている。 #駆け出しエンジニアと繋がりたい #プログラミング初心者 https://t.co/2W0shPzG4x,15,0,1300,1033,https://twitter.com/Sonsaww/status/1557683301464567808,15
1557674239712718849,web611544971,2022-08-11 10:24:13+00:00,【職業訓練校について】在学中は試験費用が半額になります！・Oracle認定Javaプログラマ・Ruby技術者認定試験制度（※職業訓練校によっては補助制度が違う可能性があるのであくまで参考でお願いします。）#プログラマー#プログラミング初学者と繋がりたい #駆け出しエンジニアと繋がりたい,31,1,1193,753,https://twitter.com/web611544971/status/1557674239712718849,32
1557659082999603200,hirokaito2,2022-08-11 09:23:59+00:00,今日（2022/8/11）木曜お盆休みに入る。ぼーっとしてる。なんて贅沢な時間。私がプログラマーを目指したのはゲームセンターの影響。お小遣いでパソコンを手に入れて毎日プログラムしてた。今は仕事では少しだけプログラムという感じ。ゲーム作る仕事ではなかった。頑張ればなんか出来るかな。頑張る💪,13,0,456,1008,https://twitter.com/hirokaito2/status/1557659082999603200,13
1557656462427848710,EngineerBarKobe,2022-08-11 09:13:35+00:00,⠀/／🗣 リニューアルオープンまであと1日！   \＼8月12日まであと1日！#ハックバー では、店長が0から開発したモバイルオーダーシステムでお酒の注文ができちゃいます😳GitHubでログインできるって噂はホント…？#神戸バー #エンジニア #プログラマー #エンジニアと繋がりたい #プログラミング https://t.co/I6MIbmPmSE,14,4,912,24,https://twitter.com/EngineerBarKobe/status/1557656462427848710,18
1557655027078295553,SatsumaEngineer,2022-08-11 09:07:52+00:00,僕は理系だったからPythonで微分が出てきても抵抗なかったが、文系の人は鳥肌が立ちそう。でも文系からプログラマーの人もいるし、最終的には気合いで乗り越えられるのかもしれないな。僕も頑張ろ！さて、次はITパスポートの勉強をしていきますよ！#Web制作#駆け出しエンジニアと繋がりたい,18,0,63,50,https://twitter.com/SatsumaEngineer/status/1557655027078295553,18
1557610115469316101,minnano_college,2022-08-11 06:09:25+00:00,【イベント情報！申込必須】8/20（土）13:00～ 「バーチャルオープンキャンパス」の開催が決定！バーチャル空間にて動画講義や参加者交流が楽しめます。世界最高齢プログラマー若宮正子様の特別講義の他、動画編集やプログラミング、SNS運用などコンテンツも盛りだくさん！https://t.co/wt7mNQOYDS,19,6,59,0,https://twitter.com/minnano_college/status/1557610115469316101,25
1557596669637578752,hirotsujino,2022-08-11 05:15:59+00:00,"素晴らしかった。伝説の（ゲーム）プログラマー John Carmack回。FPS の生みの親、Doom, Quake などの伝説的作品、Oculus 元 CTO。5 時間以上、インサイト尽くしだけど、ハンズオンの経験から来る理路整然さ、痛快な言行一致、刺激に満ちた回だったhttps://t.co/sRlE3bdFLs",45,3,1350,972,https://twitter.com/hirotsujino/status/1557596669637578752,48
1557596470097747968,ipro_akane,2022-08-11 05:15:11+00:00,兵庫県産プログラマーアイドルです🥰神戸でのライブ嬉しかったです❣️ありがとうございます🍒❤️ https://t.co/sbZUAKna2f,36,4,903,95,https://twitter.com/ipro_akane/status/1557596470097747968,40
1557586864085024768,passonco,2022-08-11 04:37:01+00:00,会社でプログラマーの人に「ゲームの敵AIってここ10年でブレイクスルーあったんですか？」と質問したところ「AIがいくら複雑化してもゲームデザイナーの意図通りに動くわけじゃないからニーズが減ったよ」と言われてなるほどと思った(複雑化は開発しやすさと面白さと因果関係がないこともある),61,18,1016,2738,https://twitter.com/passonco/status/1557586864085024768,79
1557570831919616001,ulK0f137,2022-08-11 03:33:19+00:00,話が面白い人→プログラマー話を聞くのが上手い人→デザイナー話が面白くない人→マーケターに適正ある気がする。#駆け出しエンジニアと繋がりたい #駆け出しwebデザイナーと繋がりたい,15,0,75,74,https://twitter.com/ulK0f137/status/1557570831919616001,15
1557561549661011973,sibutakiti,2022-08-11 02:56:26+00:00,本当に阪大工学部卒か？！しゃべらなければわからんじゃないけど。。 #駆け出しエンジニアと繋がりたい　 #プログラマー https://t.co/h87qaKwShP,16,2,809,794,https://twitter.com/sibutakiti/status/1557561549661011973,18
1557554344299753472,tsurujiro_drago,2022-08-11 02:27:48+00:00,プログラマーを一番苦しめる現場それはドキュメント類が一切存在しない現場です。ソースが唯一のドキュメント。実際に何度か経験しました。#駆け出しエンジニアと繋がりたい#IT開発#web開発#プログラマー #プログラミング,324,26,1455,4991,https://twitter.com/tsurujiro_drago/status/1557554344299753472,350
1557552809133805568,82tech,2022-08-11 02:21:42+00:00,0からのPython学習ならエンジニア目線、以下の教材がおすすめ😌✅独学プログラマー✅paizaラーニングとプロジェクトでパイソニスタ扱いされている私は新人ちゃんにお伝えしたとさ…🐍#Python #プログラミング #プログラミング学習 #プログラミング初心者#駆け出しエンジニアと繋がりたい,16,0,446,35,https://twitter.com/82tech/status/1557552809133805568,16
1557551859719897088,tsurujiro_drago,2022-08-11 02:17:55+00:00,IT関係が3位になっているのは納得がいかない。IT関係には高度なコミュニケーション能力は必須だよ。#駆け出しエンジニアと繋がりたい#IT開発#web開発#プログラミング#プログラマー #ソフトウェア開発 https://t.co/MrWnYCsr91,17,1,1455,4991,https://twitter.com/tsurujiro_drago/status/1557551859719897088,18
1557549866213150721,tsurujiro_drago,2022-08-11 02:10:00+00:00,本番環境にデプロイした後に元に戻す「切り戻し」って言う表現を、初めて聞いた時に違和感を覚えたのは僕だけですか？#プログラミング#IT開発#web開発#駆け出しエンジニアと繋がりたい#プログラマー,12,0,1455,4991,https://twitter.com/tsurujiro_drago/status/1557549866213150721,12
1557547636127076352,daisuke_gifu_79,2022-08-11 02:01:08+00:00,おはようございます今日は普通に出勤で振り替えて連休は13日から。祝日出勤は大変ねって言われることもありますが、プログラマーな仕事もしてるので電話来る度に思考がリセットされるからお客さんが休みのとこ多い祝日は仕事が捗りますw,19,0,150,216,https://twitter.com/daisuke_gifu_79/status/1557547636127076352,19
1557930947298746368,Equa_to_r,2022-08-12 03:24:17+00:00,学歴がないけど大手で無双できた先輩から聞いた、差をつけるためにこの時期やるべき5つのこと①秋選考に適宜出願②仮説思考・論点思考の熟読③ある程度スライドを作れるようにする④ある程度フレームワークを知っておく⑤いろんな業種業態の企業について調べて、ビジネスへの感度を高める,36,6,1230,968,https://twitter.com/Equa_to_r/status/1557930947298746368,42
1557925246149459968,yucatio,2022-08-12 03:01:38+00:00,私が思う駆け出し・一人前・つよつよエンジニア駆け出しエンジニア: 言語とフレームワークの入門書を一通り理解している一人前エンジニア: 仕事上使うツールを使いこなせるつよつよエンジニア: 仕事で使わないツールもたくさん知っている#駆け出しエンジニアと繋がりたい,26,0,163,149,https://twitter.com/yucatio/status/1557925246149459968,26
1557922531243626496,Hilltop_se,2022-08-12 02:50:50+00:00,💃🏻 夫婦ボドゲ 🕺🏻 ￣￣￣￣￣￣￣￣▶ フレームワーク🆕👩🏻22 👨🏻20 → 👩🏻22 👨🏻20 で連敗😭ノヴァルナあるのでスルー予定でしたがHAL99さんをはじめ皆さんの高評価に🛒パズル感はより強くなっており手番順はシンプルでテンポよく多人数プレイも改善されてる感じウヴェ×パズルはやはり鉄板✨ https://t.co/hY207dkvZ7,17,2,780,498,https://twitter.com/Hilltop_se/status/1557922531243626496,19
1557871238097551360,roolbackgramer,2022-08-11 23:27:01+00:00,保守に弱い言語は悲惨だ。５年後に別の言語に生まれ変わっている。使っているフレームワークが廃止されていたり、使いものにならなくなっている。保守の弱い言語はやっていはいけない。苦労することになるから 28   #駆け出しエンジニアと繋がりたい,10,0,202,2,https://twitter.com/roolbackgramer/status/1557871238097551360,10
1557868326801784832,neneko_lisa,2022-08-11 23:15:27+00:00,来週から事例Ⅱに着手出来そうなので @sun_smec サンさんのブログから事例Ⅱのフレームワーク拝借✌️😆与件文に沿った形でテンプレ回答をガチャガチャ組み合わせたら受かる気がしてきました！https://t.co/dnsDvNXc8H https://t.co/lP0aKsCmXR,29,0,616,319,https://twitter.com/neneko_lisa/status/1557868326801784832,29
1557852357781647361,yzk_unhn,2022-08-11 22:12:00+00:00,おはゆず〜🍊結局帰省中も在宅ワークなんです()通勤時間がない分寝れるのでもう少し…寝るぅ…そして遅刻(?)する未来が見えるかもしれない…仕事やお出かけでお外に行く人は水分取って熱中症気をつけて頑張りましょう☀️#おはようVtuber #推してください 🌱ゲーム画面風フレーム:ヒトブイ様 https://t.co/V68I9KhzHq,21,1,667,666,https://twitter.com/yzk_unhn/status/1557852357781647361,22
1557832992437030912,TMatsumoto_KT,2022-08-11 20:55:03+00:00,各研修に統一感を持たせる事は大切。例えば問題解決の研修でも階層によって担当者やベンダーが違うと、似たフレームワークなのに用語が異なる事で参加者が混乱をしてしまう事がある。各担当者同志で情報を共有し研修間の繋がりや用語を統一する事で共通言語も出来る。細かい所までこだわりましょう。,31,0,863,854,https://twitter.com/TMatsumoto_KT/status/1557832992437030912,31
1557722863712419842,yukiharu2021,2022-08-11 13:37:26+00:00,phpでwebアプリケーションを作るなら、フレームワークを使うことをお勧めします。初心者向けの学習サイトは、フレームワークを使わない解説がよくされていますが、実務ではフレームワークが前提になります。逆に使わないと、メンテナンスの面で効率が落ちます。#プログラミング初心者,10,0,132,105,https://twitter.com/yukiharu2021/status/1557722863712419842,10
1557705691627892737,Sys_Rider,2022-08-11 12:29:12+00:00,@tuchiryuu @mpyw 本当そうなんですよね。9割は『dockerって何？』の状態。『フレームワークも何？』の状態もあるあるです。時々所属長に『当社はWebアプリ受注出来るレベルではありません』と、言っています。,11,3,1537,376,https://twitter.com/Sys_Rider/status/1557705691627892737,14
1557700139266912256,ud_fibonacci,2022-08-11 12:07:08+00:00,"めちゃくちゃ今更ですが、#左ききのエレン を途中まで読みました。""集中力の深さ・長さ・早さ""のフレームワークは、なるほどと思ったのでした。私の場合は、集中状態に入るまでが遅いことを自覚したので、短くなるようやってみよう凡人なので概ね光一に感情移入するんだけど、若い頃のあかり様もいい",10,0,1372,1317,https://twitter.com/ud_fibonacci/status/1557700139266912256,10
1557643531665125376,digmystyle,2022-08-11 08:22:12+00:00,自分好みの眼鏡女子画像インスタで調べてたらことごとく存在感のあるセルフレームかけた女子の写真スクショしてて、眼鏡買う前になぜ私調べなかった😭ってなってる。デスクワーク用の眼鏡はセルフレーム中心に試着しよう。,11,0,147,280,https://twitter.com/digmystyle/status/1557643531665125376,11
1557642913634746369,yano_shinmei,2022-08-11 08:19:44+00:00,営業品目が違うと営業に対する考え方が違うのは当然。会社が違えば文化も違うし風土も違うのでスピード感と達成水準も違う。協業するにはフレームワークを共有して価値観を共通化することが大事。考え方の相違でしかないことを理解し合う事が成功の秘訣。,25,0,751,733,https://twitter.com/yano_shinmei/status/1557642913634746369,25
1557597092067307521,old_pgmrs_will,2022-08-11 05:17:40+00:00,webエンジニアを名乗られる方は多いですが、webと言ってもフロントエンド、バックエンドに大別されスキルで細分化されます。仕事応募の際はエンジニア種別と得意スキルはしっかり伝わるようにし、使えるフレームワークや要素技術も複数アピールできるとなお良いです。#駆け出しエンジニアと繋がりたい,20,0,541,532,https://twitter.com/old_pgmrs_will/status/1557597092067307521,20
1557573595676549120,mash_oka,2022-08-11 03:44:18+00:00,人を感動させるものを創る。そのために必要なのはマーケティング思考やフレームワークでもなく、技術でもない。大切なのはどれだけ自分が感動する経験をしてきたか。それは勉強や仕事では得られない。家族、恋人や友達と過ごす時間、アートや自然、季節イベント、その時しか体験できない時間を大切に。,35,0,696,745,https://twitter.com/mash_oka/status/1557573595676549120,35
1557570203919101953,tennisProgramer,2022-08-11 03:30:49+00:00,フレームワークを使ってると@(アノテーション)が頻繁に出てきます。最初はわからなくても、使い方を調べて身につけていくことの積み重ねが大切ですね！　急がば回れです。#駆け出しエンジニア#プログラミング初心者,17,0,721,656,https://twitter.com/tennisProgramer/status/1557570203919101953,17
1557554262502023168,tomo_it_engr,2022-08-11 02:27:28+00:00,IT関連の本、3～５年で内容が古いと感じます。特に、プログラム関連の本は言語や、フレームワークのversion変わったりしてます。夏期休暇中に本を整理しないと。#駆け出しエンジニアと繋がりたい#ベテランエンジニアと繋がりたい,27,1,1036,2070,https://twitter.com/tomo_it_engr/status/1557554262502023168,28
1557551371947487233,RSS80561644,2022-08-11 02:15:59+00:00,くり抜いて、フレームワークちょっとシャープにしてみた😊 https://t.co/8E0z88yxOz,59,0,331,194,https://twitter.com/RSS80561644/status/1557551371947487233,59
1557522522899300352,spin_my_story_s,2022-08-11 00:21:21+00:00,おはようございます🌞🗓ネイル💜転職関連登録整理💜#マケの木 もくもく会←アーカイブ見ながら自分のフレームワーク✊💜映画を観るかドラマ溜まってるの観るか…今週中にTANG観たい🤖💛所属が変わるタイミングで副業希望したらいけそうで、環境変える大事さ痛感中…#シーライクス #シーメイト,23,0,239,224,https://twitter.com/spin_my_story_s/status/1557522522899300352,23
1557513519486025728,Shin_Engineer,2022-08-10 23:45:34+00:00,インスタのUdemy広告に僕のReact講座が出てたから驚いた。Udemyでも割と認知はされ始めたみたいです。あとJavascript3大フレームワークの中だとReactが優位にシェア取ってるから、今からJavascript始めるならReactが無難だと思いますね。今だと求人も多いと思いますから https://t.co/rqBFsGyhLs,50,4,790,8,https://twitter.com/Shin_Engineer/status/1557513519486025728,54
1557507776276238336,keita_kitami_,2022-08-10 23:22:45+00:00,【動画レポ】業務改善の進め方／フレームワークを学ぶ！～計画段階で差が付く関係者会議の秘訣～｜keita #note https://t.co/WnUrOj3Hba #RPALT シイエム・シイのバンブーさんによる業務改善の進め方の動画が公開されましたのでレポートします。日中のイベントなので見れなかった人はどうぞ,11,2,1187,1597,https://twitter.com/keita_kitami_/status/1557507776276238336,13
1557504189454237696,EITA_ART,2022-08-10 23:08:30+00:00,ソーラーパネルの絵なので陽の光が当たる場所に設置してくださいとのこと絵画の常識にあらずで非常に面白いまたいろいろ語りたくなるけどこれはヤバいな…僕の好きな木や植物を少し写した色彩が嬉しい🌳黒坂祐さん「reflected sunlight」S8(コミッションワーク) ✼木製フレーム台座は自作にて https://t.co/Zrnc3pymeQ,80,4,302,137,https://twitter.com/EITA_ART/status/1557504189454237696,84
1557495222200049664,EkofF69d1UhqBDX,2022-08-10 22:32:52+00:00,診断士2次試験は一次試験の知識や「幸の日も毛深い猫」などのフレームワークも必要だけど、抽象化🔁具象化の能力が一番重要じゃないかと思ってきた。,16,0,108,63,https://twitter.com/EkofF69d1UhqBDX/status/1557495222200049664,16
1557487076299476994,UEcomerce,2022-08-10 22:00:30+00:00,社会人7年目のベンチャー企業時代は30分以内で企画書を作って社長に見せてた。企画書はA4でフォーマット化、ROIまで入ってる。考慮漏れがないようメジャーなフレームワークを５つくらい利用。今はすっかり大企業病に侵されそのスピード感が無い。品質も大差無い、、人は必ずしも進化するとは限らじ,38,0,663,659,https://twitter.com/UEcomerce/status/1557487076299476994,38
1557393753903886337,daemon1995,2022-08-10 15:49:40+00:00,@kazuho いや、そんなのつい最近、GNU/Linuxが普及したお陰。その前はOSもコンパイラもライブラリやフレームワークも有料で(ハードより高い)、ライセンス契約やリバースエンジニアリングや再利用禁止、NDA守秘義務契約を結ぶのに他のエンジニアリングより費用も手間暇も掛かる分野やってんで。,11,4,1692,1368,https://twitter.com/daemon1995/status/1557393753903886337,15
1557392606966865922,yokoham79911370,2022-08-10 15:45:07+00:00,beautifulsoupで、大体2日ぐらいでスクレイピング1本作って20万円。最近web系と言ってもフレームワークでwebアプリ作るより、API叩いたり、ブロックチェーン叩いたりと即席ツール作った方が儲かる。世はなにかとDXなんすね👍#駆け出しエンジニア #駆け出しエンジニアと繋がりたい,18,0,801,461,https://twitter.com/yokoham79911370/status/1557392606966865922,18
