1553228790469652482,bebebensan,2022-07-30 03:59:35+00:00,おはようございます！7月目標:AWS StepFunctions / Lambda / Pythonを連動させた仕組みと制御の理解タスク・vue.js2の使用方法の調査+動作確認（業務で必要なため） #プログラミング #プログラミング学習  #エンジニア #エンジニア初心者 #駆け出しエンジニアと繋がりたい #今日の積み上げ,12,0,436,923,https://twitter.com/bebebensan/status/1553228790469652482,12
1553227024545636352,Python_yuu,2022-07-30 03:52:34+00:00,こちらのツイート100いいね超えてびっくりです「Pythonで出来ること」について知りたい人多いのかな家計簿以外にもっと知りたい人いいねお願いします👍#プログラミング初心者#駆け出しエンジニアと繋がりたい https://t.co/CMhIakO6k4,10,0,165,226,https://twitter.com/Python_yuu/status/1553227024545636352,10
1553211088174518277,reading_earth,2022-07-30 02:49:15+00:00,#しゅきメモ#応用情報技術者試験#駆け出しエンジニアと繋がりたい クロス開発プログラムを開発するマシン環境と実行するマシン環境が異なること例）自身の作成しているpythonの分析ツール（開発）Windows上のpython　⇔（実行）Ubuntu上のpython,12,1,545,382,https://twitter.com/reading_earth/status/1553211088174518277,13
1553208274865885184,ikukyuuzinzinia,2022-07-30 02:38:04+00:00,Pythonでブラウザ操作の自動化を実装しようとすると、画面要素の指定など一個ずつ確認したりで面倒なことないでしょうか？seleniumIDEを併用しつつ楽する方法を記事にしました！🙂https://t.co/rC2RabtV1Z#駆け出しエンジニアと繋がりたい #Python #業務改善 #selenium #ブログ,14,1,106,75,https://twitter.com/ikukyuuzinzinia/status/1553208274865885184,15
1553207246565556224,itigo_engineer,2022-07-30 02:33:59+00:00,Twitterから指定IDのツイートを取得してExcelに出力するアプリケーションが使用されました。AID:_uKY-AZ9YXk 2022年07月30日 11:33:59#Python#駆け出しエンジニアと繋がりたい#駆け出しエンジニアsokuure,11,1,9,1,https://twitter.com/itigo_engineer/status/1553207246565556224,12
1553197005975203843,Tooru_Mihori,2022-07-30 01:53:17+00:00,@cari_meli pythonと言えばMontyPython！(ﾟ∀ﾟ) https://t.co/0KrntH3LW0,15,4,807,546,https://twitter.com/Tooru_Mihori/status/1553197005975203843,19
1553188272763187200,wkwkdkdk_psi,2022-07-30 01:18:35+00:00,Hello World!!今日のpickup記事はこちら!※これは定期tweetですhttps://t.co/kzZugLLx2K#blog #ブログ #ブログ初心者 #ブログ仲間 #ブログ仲間募集#python #自動化,10,1,215,254,https://twitter.com/wkwkdkdk_psi/status/1553188272763187200,11
1553186939016462336,sBu5JmF34Xhe2aM,2022-07-30 01:13:17+00:00,#今日の目標勉強する　Gitにて構成・コードを少しでも見たい#医療事務 #python #駆け出しエンジニアと繋がりたい#プログラミング初心者と繋がりたい #coding #programming #pythonlearning,15,3,53,24,https://twitter.com/sBu5JmF34Xhe2aM/status/1553186939016462336,18
1553181476560437248,Nameless_SN,2022-07-30 00:51:35+00:00,FastAPIでマイクロサービスを開発するチュートリアル。【主な内容】☑FastAPIの非同期通信☑FastAPIとMongoDBの連携来月4日にKindleで配信される。FastAPIを学びたいので楽しみ。https://t.co/xZmClk9rhD#駆け出しエンジニアと繋がりたい#今日の積み上げ#プログラミング#Python #FastAPI,16,1,545,1,https://twitter.com/Nameless_SN/status/1553181476560437248,17
1553181287422525440,itigo_engineer,2022-07-30 00:50:50+00:00,Twitterから指定IDのツイートを取得してExcelに出力するアプリケーションが使用されました。AID:_uKY-AZ9YXk 2022年07月30日 09:50:50#Python#駆け出しエンジニアと繋がりたい#駆け出しエンジニアgomachandakedo,14,1,9,1,https://twitter.com/itigo_engineer/status/1553181287422525440,15
1553176058991886336,itigo_engineer,2022-07-30 00:30:03+00:00,Twitterから指定IDのツイートを取得してExcelに出力するアプリケーションが使用されました。AID:_uKY-AZ9YXk 2022年07月30日 09:30:03#Python#駆け出しエンジニアと繋がりたい#駆け出しエンジニアnononolifestyle,20,2,9,1,https://twitter.com/itigo_engineer/status/1553176058991886336,22
1553176050170884096,y__hayashi,2022-07-30 00:30:01+00:00,10分で環境構築が終わります。その間はコーヒーでも飲んでいてください https://t.co/ucQNXnOUmk#buildree #php #Laravel #fuelphp #フレームワーク #apache #nginx #エンジニア #python #go #nodejs #プログラミング学習 #プログラミング初心者,13,3,172,70,https://twitter.com/y__hayashi/status/1553176050170884096,16
1553173183850631168,Prog_Press,2022-07-30 00:18:38+00:00,「Pythonデータ分析」をはじめた人が入門書の次に読むとよい本 Python実践データ分析100本ノック#駆け出しエンジニアと繋がりたい #プログラミング初心者 #Python #Progatehttps://t.co/hxvctuepbL,14,0,35,1,https://twitter.com/Prog_Press/status/1553173183850631168,14
1553173086790643712,itigo_engineer,2022-07-30 00:18:15+00:00,Twitterから指定IDのツイートを取得してExcelに出力するアプリケーションが使用されました。AID:_uKY-AZ9YXk 2022年07月30日 09:18:14#Python#駆け出しエンジニアと繋がりたい#駆け出しエンジニアnononolifestyle,11,0,9,1,https://twitter.com/itigo_engineer/status/1553173086790643712,11
1553171982413594625,VTPP8,2022-07-30 00:13:51+00:00,プログラミングの勉強が楽しいです。本日午前は運動したり、ちょっと外出したりするけど、午後はpython漬けにするつもりです！#おは戦40730jd 🍩#おはよう戦隊くん,24,0,740,1359,https://twitter.com/VTPP8/status/1553171982413594625,24
1553163841881526272,er87673491,2022-07-29 23:41:30+00:00,FX自動売買今週は2勝1敗の+608円プログラムを順張り型に変えてひと月たったがとりあえず方向性はこれで。利確位置をもう少し調整してみる。ボリンジャーを導入したいがまだ手付かず。この夏やる。#FX自動売買 #プログラミング初心者#Python,10,0,28,22,https://twitter.com/er87673491/status/1553163841881526272,10
1553159270988128256,itigo_engineer,2022-07-29 23:23:21+00:00,Twitterから指定IDのツイートを取得してExcelに出力するアプリケーションが使用されました。AID:_uKY-AZ9YXk 2022年07月30日 08:23:20#Python#駆け出しエンジニアと繋がりたい#駆け出しエンジニアyoshi_buppan,10,0,9,1,https://twitter.com/itigo_engineer/status/1553159270988128256,10
1553156616467337217,miyashin_prg2,2022-07-29 23:12:48+00:00,PythonでPillowを使って写真や画像の大きさ変更、切り抜き方法をご紹介します😀Pillowは実践でもよく使うライブラリですね😆サンプルコード付ですのでコピペしてお使いください👍#Python#駆け出しエンジニアと繋がりたい#プログラミング初心者#今日の積み上げ#朝活 https://t.co/tto7kgF775,24,1,108,55,https://twitter.com/miyashin_prg2/status/1553156616467337217,25
1553151735002443777,shake05200226,2022-07-29 22:53:24+00:00,おはしゃけ🐟今日も朝活から積み上げましょう#今日の積み上げ ①基本情報技術者試験②Salesforce学習③Java学習④Python学習朝ウォーキングから朝活、休日出勤です😭その分しっかり成長してやる💪#プログラミング学習#駆け出しエンジニア#Python#Vue.js #spring#Java,11,0,670,267,https://twitter.com/shake05200226/status/1553151735002443777,11
1553146109551611904,SmashBlack0190,2022-07-29 22:31:03+00:00,独習Python。以前、時間かけて通読したけど、ほとんど覚えられませんでした。😭でも、たまに辞書代わりに手に取ります。😙今朝は久しぶりに出てきたlambda 式。☺️ https://t.co/k1Cqjuvnc0,22,0,611,364,https://twitter.com/SmashBlack0190/status/1553146109551611904,22
1553145852264615936,y__hayashi,2022-07-29 22:30:01+00:00,シェルを実行！待っていれば欲しい環境が目の前に https://t.co/ucQNXnxRkk#buildree #php #Laravel #fuelphp #フレームワーク #apache #nginx #エンジニア #python #go #nodejs #プログラミング学習 #プログラミング初心者,10,2,172,70,https://twitter.com/y__hayashi/status/1553145852264615936,12
1553143075991859200,issa50s_2022,2022-07-29 22:18:59+00:00,#朝勉部Python paiza C問題じゃーん　paizaランクC  (^^♪　ランクアップ～#テックカレッジジョギング63.2kg現在のあなたのpaizaレーティングは【1716】#paiza #paiza_rating https://t.co/eRSqaWBdCE,12,0,405,487,https://twitter.com/issa50s_2022/status/1553143075991859200,12
1553139583868899328,wakame_msds,2022-07-29 22:05:07+00:00,先日、50代のリーダーから「Python 使いたいから教えて欲しい」と言われた。「若手に学べと勧めてるけど、自分も使えないと説得力ないよね」とのこと。いろんな意見あるだろうけど、いくつになっても新しいものを学ぼうとする姿を自分は尊敬。リーダーがこうやって動いてくれるのもありがたい。,24,0,594,247,https://twitter.com/wakame_msds/status/1553139583868899328,24
1553132398228824065,RPA_python,2022-07-29 21:36:34+00:00,おはようございます。朝活150日目🍅*6・python(2)uwgi・小論文(2)高校ごとの学力差・マニュアル作成(2)散歩からスタート#駆け出しエンジニアと繋がりたい#病み垢さんと繋がりたい #いいねした人全員フォロー #フォロバ100 #今日の積み上げ #python#朝活#RPA#読書,47,0,433,493,https://twitter.com/RPA_python/status/1553132398228824065,47
1553125755327942656,HotamMi,2022-07-29 21:10:10+00:00,おはようございます☀️今日は、高校時代の友人たちと飲むので楽しみな一日でございます🍺それまでにやること終わらす…AMで終わらす…0730 #今日の積み上げ✓英会話宿題✓Vue仕事（朝から役に立たんかった！なんだかくやしい）✓Python勉強#レッツ朝活サロン#駆け出しエンジニアと繋がりたい,33,1,427,388,https://twitter.com/HotamMi/status/1553125755327942656,34
1553228790469652482,bebebensan,2022-07-30 03:59:35+00:00,おはようございます！7月目標:AWS StepFunctions / Lambda / Pythonを連動させた仕組みと制御の理解タスク・vue.js2の使用方法の調査+動作確認（業務で必要なため） #プログラミング #プログラミング学習  #エンジニア #エンジニア初心者 #駆け出しエンジニアと繋がりたい #今日の積み上げ,12,0,436,923,https://twitter.com/bebebensan/status/1553228790469652482,12
1553219204509143041,maron43d,2022-07-30 03:21:30+00:00,超絶お待たせいたしました🙏😭ランドマークマップ完成しました✨弊社の天才エンジニア派遣社員ひもが睡眠を削り、血と汗と涙を流し、一から全て手作りのランドマークマップです！！らぶりつお願い🥺💓運営管理・マップ作製 ( ひも )🐚🌻 @himomon_ #マロンカスタム #apex #APEXカスタム https://t.co/YawWxFwcFy,18,6,307,254,https://twitter.com/maron43d/status/1553219204509143041,24
1553214848242274304,hikari0net,2022-07-30 03:04:11+00:00,ITエンジニアへの未経験転職を目指す方へのおすすめエージェントをプロフィールでまとめてます！実際使って今現役です#エンジニア転職 #未経験エンジニア #駆け出しエンジニアと繋がりたい,10,0,888,376,https://twitter.com/hikari0net/status/1553214848242274304,10
1553206754275500032,tip1t,2022-07-30 02:32:02+00:00,仕事を貰う感覚のエンジニアはポートフォリオを作ると「さぁなんでも仕事ください！」と待ち状態に。これだと「忙しいから任せたい」「もっと安く頼みたい」など相手都合でしか仕事が発生しない。仕事は「それこうしたらもっと良くなります」と指摘して生み出すもの。#駆け出しエンジニアと繋がりたい,14,0,267,8,https://twitter.com/tip1t/status/1553206754275500032,14
1553204311550996480,uneda_b,2022-07-30 02:22:19+00:00,最近の若いもんは無線系エンジニアにはなりたがらんのやな〜とジジイ発言。 #駆け出しエンジニアと繋がりたい,11,0,351,388,https://twitter.com/uneda_b/status/1553204311550996480,11
1553199282207227904,suica_diary,2022-07-30 02:02:20+00:00,炎上の末、今まさに開発中止になったプロジェクトを見た人の表情#プログラミング#エンジニア#駆け出しエンジニアと繋がりたい https://t.co/zOD5Wmuiqq,11,0,284,263,https://twitter.com/suica_diary/status/1553199282207227904,11
1553199274846199810,kosshichaohuoe1,2022-07-30 02:02:18+00:00,初心者エンジニアの方は、extensionを使いこなせれば、かなりレベルアップできると思います。かなりコードが整理できますし、開発できるアプリの幅がかなり広がります。#初心者エンジニア#駆け出しエンジニアと繋がりたい #flutter,14,0,33,21,https://twitter.com/kosshichaohuoe1/status/1553199274846199810,14
1553195731552505856,abechan_front,2022-07-30 01:48:14+00:00,エンジニア転職において一番大切なこと会社と自分の価値観が一致しているか採用側もこの点を重要視しています。さらに、この点においてしっかり準備できている人は少ないです。自分が本当に行きたい数社に絞って事前に企業調査を行いましょう。#駆け出しエンジニアと繋がりたい,12,0,424,143,https://twitter.com/abechan_front/status/1553195731552505856,12
1553195168178008064,315tkh,2022-07-30 01:45:59+00:00,#今日の積み上げ メモ✅HTML/CSSのローカル開発環境を構築しよう終了まずは、HTMLからスタート。昔ホームページビルダーとか触ってた頃を思い出す。#駆け出しエンジニア#駆け出しエンジニアと繋がりたい#ウェブデザイン#侍エンジニア#侍テラコヤ#侍エンジニア,14,0,26,196,https://twitter.com/315tkh/status/1553195168178008064,14
1553192365686304768,oyomechan_fight,2022-07-30 01:34:51+00:00,どっかのコミュニティ入りたいなぁ…おすすめありませんか？フロントエンド学びたくて😭 #エンジニア  #プログラミング初心者  #駆け出しエンジニアと繋がりたい  #コミュニティ  #フロントエンド  #プログラミング勉強中,20,0,360,378,https://twitter.com/oyomechan_fight/status/1553192365686304768,20
1553190456380784643,buchopowerpoint,2022-07-30 01:27:16+00:00,ホントにその通り。SIerでも顧客の事を理解してソリューションを提供する方もいるし、自社開発でも会社のビジョンや戦略を理解せずに派閥争いに躍起になる者も多しどっちの会社が良いのか？という若手エンジニアほど早く事業貢献の大切さに気づいて欲しい#駆け出しエンジニアと繋がりたい https://t.co/mQWuLgOeIj,12,1,24,48,https://twitter.com/buchopowerpoint/status/1553190456380784643,13
1553189249628794883,POJ1wlPOerUiaEO,2022-07-30 01:22:28+00:00,#今日の積み上げ おはようございます。・JavaScriptの勉強・ノーコードの勉強・英語の勉強今日も1日頑張るぞーー＃プログラミング #エンジニア  #Webデザイナー,13,0,132,37,https://twitter.com/POJ1wlPOerUiaEO/status/1553189249628794883,13
1553187653524533249,namake_web,2022-07-30 01:16:08+00:00,クロネコ屋さん(＠NINJAkusokuso)の #ゼロから講座 を購入。エンジニアが発信する技術系の記事って直接的にお金になりにくい。と読む前は思っていましたが、クロネコ屋さんの言う「ズラし」を使って一石二鳥を狙いたいと思います。#駆け出しエンジニアと繋がりたい https://t.co/Jw8eVMqDlQ,14,0,57,65,https://twitter.com/namake_web/status/1553187653524533249,14
1553187193815937024,coffeecookie14,2022-07-30 01:14:18+00:00,みんな呟いてるけど、200円の返金をエンジニアさんの給料に充てて欲しい。もしくは法人の弁償に充てて、余ったぶんそのままエンジニアさんの臨時収入にしてあげて欲しい。元システムとして他人事ではない出来事だった。本当に復旧お疲れ様でした。ありがとうございました。 #au,10,0,173,216,https://twitter.com/coffeecookie14/status/1553187193815937024,10
1553005843787956229,sBu5JmF34Xhe2aM,2022-07-29 13:13:41+00:00,#フリーランスと繋がりたい #医療事務 #python #駆け出しエンジニアと繋がりたい#プログラミング初心者と繋がりたい #coding #programming #pythonlearning#電子カルテ　#機械学習　#開発　準備電子カルテ　開発　事前準備　③ - AI×医療事務(カナダ）https://t.co/bkYZlfsx4g,13,1,53,24,https://twitter.com/sBu5JmF34Xhe2aM/status/1553005843787956229,14
1552804944947716096,chadukeumebosh1,2022-07-28 23:55:23+00:00,応物来てね！＃応用物理 #応用物理学科 ＃先進工学部 ＃工学院大学 ＃工学院 #半導体 ＃太陽電池 ＃リチウムイオン電池 #LED ＃光通信 ＃レーザー ＃ディスプレイ ＃顕微鏡 ＃創薬 ＃隕石 ＃紫外線 ＃宇宙 ＃宇宙用材料 ＃ハードディスク #機械学習 ＃プログラミング ＃ビッグデータ #電気自動車 https://t.co/PEb2E1bijD,11,0,445,507,https://twitter.com/chadukeumebosh1/status/1552804944947716096,11
1552647218192326656,H4Tnuy,2022-07-28 13:28:38+00:00,統計検定2級、準1級、JDLA のG検定に合格する中で、「統計学・機械学習について結局何が学べた？」か、思い出しながら書いてみました。これからチャレンジする方は是非読んでみてください！！！#統計検定#機械学習#G検定#E検定https://t.co/gXMU5EOO3M,21,0,231,432,https://twitter.com/H4Tnuy/status/1552647218192326656,21
1552308792343244800,ai_gajumaru,2022-07-27 15:03:51+00:00,製造業で設備の故障予測をしようにも、故障中の教師データがほとんど無い事がある。設備がそもそも故障しないように設計されているため。#AI #機械学習 #人工知能,10,0,170,222,https://twitter.com/ai_gajumaru/status/1552308792343244800,10
1552228246011334656,mofu_usam,2022-07-27 09:43:47+00:00,109日目えげつない量の日本語データをまとめて翻訳するツールを作成しました投稿は気が向いたら基本毎日勉強中#機械学習#100日間pythonを勉強してみる#Python #プログラミング初心者　#プログラミング独学 #駆け出しエンジニアと繋がりたい,21,0,688,418,https://twitter.com/mofu_usam/status/1552228246011334656,21
1551991014520340485,OjiTec,2022-07-26 18:01:07+00:00,現在、おすすめ本コーナーでは、機械学習で統計処理を行ったITエンジニアが読んでいそうなビジネス書を紹介しています。https://t.co/Z0PhGhh19e#おすすめ本 #機械学習 #プログラミング,11,0,290,40,https://twitter.com/OjiTec/status/1551991014520340485,11
1551930467519442944,mofu_usam,2022-07-26 14:00:31+00:00,108日目scrapyで画像をファイル名指定してDLできるようになりましたもうこれで画像ファイル管理も楽だな投稿は気が向いたら#機械学習#100日間pythonを勉強してみる#Python #プログラミング初心者　#プログラミング独学 #駆け出しエンジニアと繋がりたい,23,0,688,418,https://twitter.com/mofu_usam/status/1551930467519442944,23
1551585189423288320,noocri,2022-07-25 15:08:30+00:00,本日の学習記録「Python for data science and machine learning bootcamp」Chapter19まで読書運がいいと言われる人の脳科学Vol12まで決定木とランダムフォレスト#エンジニア#機械学習#読書#今日の積み上げ,10,3,38,30,https://twitter.com/noocri/status/1551585189423288320,13
1551570535196200960,higamasa21,2022-07-25 14:10:17+00:00,クラスタ分析のk-means法について勉強しました✨ついに始まった教師なし学習最もよく知られている(らしい)k-means法は便利だが、クラスタの数を指定しなきゃならない対策として、エルボー法で最適な個数を事前に求めるのが一般的みたい#Python #機械学習 #駆け出しエンジニアと繋がりたい,19,0,27,58,https://twitter.com/higamasa21/status/1551570535196200960,19
1551355283527544832,Bedyu1VlD7BXWyU,2022-07-24 23:54:57+00:00,双曲平面上が階層構造をコンパクトに表現できることを利用して、自然言語処理のword2vecの機械学習に応用されているみたいな記事を発見してはえーってなった。#機械学習 #幾何学https://t.co/RYS8h490Px,31,6,37,65,https://twitter.com/Bedyu1VlD7BXWyU/status/1551355283527544832,37
1551130126888337408,hirasu1231,2022-07-24 09:00:15+00:00,Python + ESPnetで日本語の音声合成(TTS)を実装するhttps://t.co/W0giIc6BoH#Python #AI #機械学習#ESPnet #機械音声 #音声合成#プログラミング#プログラミング勉強中#駆け出しエンジニアと繋がりたい#駆け出しwebデザイナーと繋がり,18,0,153,354,https://twitter.com/hirasu1231/status/1551130126888337408,18
1551067772763127808,selfdevelop2019,2022-07-24 04:52:29+00:00,ブログ連続更新835日#ブログ #プログラミング勉強中  #プログラマー #機械学習 #スクレイピング #Python #プログラミング #PHP #Ubuntu #仮想通貨 #メタバース #プログラミング独学 https://t.co/l9KlZ1aTZL,10,0,137,0,https://twitter.com/selfdevelop2019/status/1551067772763127808,10
1550824073432670209,ai_gajumaru,2022-07-23 12:44:06+00:00,どのテーマにどの特徴量があると良いかは一概に言えないが、需要予想の場合は大抵過去実績が一番効く。#AI #機械学習 #人工知能,17,1,170,222,https://twitter.com/ai_gajumaru/status/1550824073432670209,18
1550426775783866368,gigagent,2022-07-22 10:25:23+00:00,「Pythonで儲かるAIをつくる」プログラムの勉強というより統計の勉強になった。統計勉強した事ない人はキツイかも。#Python #AI #機械学習 #駆け出しエンジニアと繋がりたい #プログラミング初心者と繋がりたい #独学 #儲け #勉強 #統計 https://t.co/7tLSu0G64L,28,2,66,154,https://twitter.com/gigagent/status/1550426775783866368,30
1550262244159926272,gigagent,2022-07-21 23:31:36+00:00,今日は午前中雨みたいなので引き続きAIの勉強。この本、プログラムと言うよりAIに学習させるためのデータ準備、アルゴリズムの特徴、評価、チューニングについて書かれている。#独学　#勉強 #AI #機械学習 #プログラミング初心者と繋がりたい #駆け出しエンジニアと繋がりたい #ギクワーク https://t.co/uQFPOPiulI,13,0,66,154,https://twitter.com/gigagent/status/1550262244159926272,13
1550074357703012352,yasunori_cv,2022-07-21 11:05:00+00:00,YOLOシリーズのリンク集著者も書いてくださっているので、改めて、どれが本家から繋がっているのかを思い出せました。#機械学習#AIhttps://t.co/OZwX0ciFmL,10,2,176,313,https://twitter.com/yasunori_cv/status/1550074357703012352,12
1553162084833456129,yachts111xenon,2022-07-29 23:34:32+00:00,「データをさらにディープラーニングさせてマシンラーニングさせることが本当のDX」知らんかった…！本当のDX！孫正義社長、円安を嘆く「かつては世界1位2位を争っていた国」「競争力向上にAIが必須」 https://t.co/CKYBTtXN36 @cnet_japanより,20,9,904,387,https://twitter.com/yachts111xenon/status/1553162084833456129,29
1553032937528242178,miyabi_kei_ex,2022-07-29 15:01:20+00:00,@cari_meli パッチワーク的な手法に対して、AIのディープラーニング的手法はすべてのモデルをスライドフィルムのように重ね合わせて、ぼかした輪郭を拾ってる感じがありますね。,149,23,587,965,https://twitter.com/miyabi_kei_ex/status/1553032937528242178,172
1552962072237195265,cqevdEcH3wq8ldm,2022-07-29 10:19:45+00:00,udemyでPytorchで学ぶディープラーニング実装講座を試聴。これまたAVILENのコンテンツだった！この講師頭いいし勢いあって楽しい！#E資格#中小企業診断士#python #プログラミング初心者 #Avilen,13,0,44,45,https://twitter.com/cqevdEcH3wq8ldm/status/1552962072237195265,13
1552928412519567362,SE89649663,2022-07-29 08:06:00+00:00,・ディープラーニングを学ぶのにお勧めなスクールはある？テックアカデミーのAIコースがお勧め。ただし、pythonの基礎知識は前提で必要なのでプログラミング中級者向け。本格的にAIで副業するスキルは身に付く。#プログラミング初心者 #駆け出しエンジニアと繋がりたい https://t.co/XBR7b9qNZS,12,0,964,924,https://twitter.com/SE89649663/status/1552928412519567362,12
1552654196427501568,extreme877,2022-07-28 13:56:22+00:00,@marketmaker7 年初金融系の人たちから聞いたんですが、パッタリAIのシステム取引の営業の話が来なくなったと言ってました。去年までは沢山あったのにと。数年前の日銀の発表の日なんか分足で上下の動き凄かったんですけどねWAIも機械学習とディープラーニングと違うから、精度の問題で変なワード引っかけるでしょね,11,1,278,122,https://twitter.com/extreme877/status/1552654196427501568,12
1552599395803492352,soichiro_jpisr,2022-07-28 10:18:36+00:00,@poyothon FF外から失礼します。たまたま目に止まったもので。Interface9月号をお求め頂くと、来年1月までのMATLABライセンスが付録でついてきます。機械学習やディープラーニングのToolboxも使えますよ！この機会にお試し頂けると嬉しいです😊,10,1,89,103,https://twitter.com/soichiro_jpisr/status/1552599395803492352,11
1552579733623226369,kira_python,2022-07-28 09:00:28+00:00,Pythonでは、何かやりたいと思ったことは難なく実現できます。Webアプリからデスクトップアプリ、バッチ処理、ゲーム、IoT、ロボット、科学計算、人工知能、機械学習、ディープラーニング、など数え切れないぐらいあります🧑‍💻#エンジニア#プログラミング#駆け出しエンジニアと繋がりたい,39,0,519,368,https://twitter.com/kira_python/status/1552579733623226369,39
1552535819356753922,toramimimuginon,2022-07-28 06:05:58+00:00,おお、スゴ！これ有ればいろんな曲分解して勉強出来るから良いなぁ！！ソニー開発のディープラーニングによる世界最高の音源分離技術を利用できる、音楽制作サービス、Soundmain https://t.co/ajd0eAorSl @dtmstationから,19,9,189,349,https://twitter.com/toramimimuginon/status/1552535819356753922,28
1552413576228487172,hisayuki_ik,2022-07-27 22:00:13+00:00,おはようございます。ここ数日でセミが鳴くようになりましたね。セミの鳴き声をディープラーニングしたらセミの鳴く理由がわかったりするのでしょうか？本日も頑張ってまいりましょう。,13,0,580,636,https://twitter.com/hisayuki_ik/status/1552413576228487172,13
1552409959983620096,Kamichan_R,2022-07-27 21:45:51+00:00,おはようございます😆#朝活 342日目です！&gt;#今日の積み上げ#散歩  #ディープラーニング #読書今日もレポート課題を頑張ります！流石に3つあるとちょっと大変だけど、締切が近いし、頑張り時ですね。考査勉強もしなければならない…今日も良い1日を〜😁,10,0,147,140,https://twitter.com/Kamichan_R/status/1552409959983620096,10
1552379813150609408,MusicCreatorJP,2022-07-27 19:46:03+00:00,ソニー開発のディープラーニングによる世界最高の音源分離技術を利用できる、音楽制作サービス、Soundmain https://t.co/XIgjHFHB8T https://t.co/4OqPJ3jPli,16,6,739,215,https://twitter.com/MusicCreatorJP/status/1552379813150609408,22
1552220646536581120,NLP_sue,2022-07-27 09:13:35+00:00,その通りだと思う。コーディングは簡単なものはコピペでできる。ディープラーニングとか関数の理論もよくよく見ると簡単な数式。ただ初見はめちゃくちゃ難しく見えるから、入門を突破する気合と根性が必要。。 https://t.co/wngPGBcz8V,11,0,70,86,https://twitter.com/NLP_sue/status/1552220646536581120,11
1552198276698365952,sumico55895357,2022-07-27 07:44:42+00:00,ツールとしてテクノロジーも必要AI、データサイエンス、機械学習、ディープラーニング、、web3?ただし自力では力及ばす🙅‍♀️(基本の統計学とプログラミングだけで精一杯)Health🤝Tech,13,0,371,464,https://twitter.com/sumico55895357/status/1552198276698365952,13
1551668619175931904,Kamichan_R,2022-07-25 20:40:02+00:00,おはようございます😆#朝活 340日目です！&gt;#今日の積み上げ#散歩  #ディープラーニング #読書今日は朝イチで大学があります！レポート課題がたくさんあるので、早めに消化したいと思います！今日も良い1日を〜😁,17,0,147,140,https://twitter.com/Kamichan_R/status/1551668619175931904,17
1553213802383978496,suzuki_py,2022-07-30 03:00:02+00:00,Qiitaで #HTTP に関する投稿を定期的に漁ってます！#プログラミング#プログラミング初心者#駆け出しエンジニアと繋がりたいサクッとAPIを叩く方法 (VS CodeでHTTPリクエストが送れちゃう拡張機能)https://t.co/njttdOq03b,19,0,487,311,https://twitter.com/suzuki_py/status/1553213802383978496,19
1553211326238928898,api_bitaeniata,2022-07-30 02:50:12+00:00,濃厚えびラーメン＆チャーシュー丼で腹いっぱい😄#我駆 https://t.co/lix920vMlX,10,0,425,352,https://twitter.com/api_bitaeniata/status/1553211326238928898,10
1553192394560249856,torounotikara,2022-07-30 01:34:58+00:00,APIふざけんな今日何回目だそろそろキレてお前のこと食うぞ,10,0,314,351,https://twitter.com/torounotikara/status/1553192394560249856,10
1553152354379186176,hanatomura,2022-07-29 22:55:52+00:00,7/30 day1437/29 7h30min応用編10rails復習＆APIについてActiveRecord演習応用rails完了！！ポートフォリオに盛り込むことになりそうな基礎技術オンパレードだったので、卒業試験前あたりで、Notion振り返りDAYを作ろう週進捗 23h50min  4.76h/日平均総学習時間:594h50min#RUNTEQ,10,0,101,83,https://twitter.com/hanatomura/status/1553152354379186176,10
1553142475945979904,k_ur6s,2022-07-29 22:16:36+00:00,朝からAPIに絡まれるの何,16,0,451,364,https://twitter.com/k_ur6s/status/1553142475945979904,16
1553071942579933184,Lynxnoir,2022-07-29 17:36:20+00:00,@API_Ukraine @May_Roma もっと昔に漫画の「リングにかけろ」に「オデッサファイル」という単語が出てきまして、それで初めてオデッサを知りました。,10,4,44,599,https://twitter.com/Lynxnoir/status/1553071942579933184,14
1553044633093304320,hammer_api,2022-07-29 15:47:49+00:00,ホイグネイ色々①アマクロ②Z4③ウパタ④クノベン https://t.co/aU0FFo8AoJ,24,0,95,56,https://twitter.com/hammer_api/status/1553044633093304320,24
1553038266751864833,micheelinCPOG,2022-07-29 15:22:31+00:00,💙✎ 林柠lney»» https://t.co/37kNrmN53j#กันอรรถพันธ์#GunAtthaphan https://t.co/WQi7oeYBrD,14,3,348,60,https://twitter.com/micheelinCPOG/status/1553038266751864833,17
1553036956514549760,Mh2G0a,2022-07-29 15:17:19+00:00,八満？あなた勉強してないでしょ？ww尊さ1000％ショートラブコメ!! 「可愛いだけじゃない式守さん/【152話】」を読んだよ！ #マガポケ https://t.co/e1kchufGTJ https://t.co/e1kchufGTJ,12,0,388,905,https://twitter.com/Mh2G0a/status/1553036956514549760,12
1553035476822798337,api_ado2,2022-07-29 15:11:26+00:00,なんで？ https://t.co/HwLkj93cd5,15,0,582,558,https://twitter.com/api_ado2/status/1553035476822798337,15
1553033284979830784,akari_hornico,2022-07-29 15:02:43+00:00,7/30⑴審査対象　#RT希望 【apiちゃん🐰💰最終日】初日にコラボしてくれたapiちゃん本日ABANAHA🍺ビールイメージガールオーディション最終日23時まで❗１位イメージガール確定✨２位〜４位の中から1名が審査員賞です！皆で応援してね📣https://t.co/EUAYKYy61F#MissBouquet #ミクチャ https://t.co/NU3t4D0Z8I,42,92,985,453,https://twitter.com/akari_hornico/status/1553033284979830784,134
1553025125662228480,kuro_xx_rabbit,2022-07-29 14:30:18+00:00,はい、API,27,0,850,759,https://twitter.com/kuro_xx_rabbit/status/1553025125662228480,27
1553024708152823819,ayame_keiba,2022-07-29 14:28:38+00:00,今日4度目のAPIにより萎えたので大人しく寝ます😭,13,0,924,899,https://twitter.com/ayame_keiba/status/1553024708152823819,13
1553022136901517312,Biztaro2022,2022-07-29 14:18:25+00:00,8:00 - 12:00までUdemyにてJava活本日のお品書き•API •パッケージあと総合問題を解けばオブジェクト指向再び。。前回の私とは違う！と思う。あと初Uber配達完了🎉体動かせてお金貰えるので気分転換にいいかも☺️今から演習問題解き直して寝ます🙃#駆け出しエンジニアと繋がりたい #Java,17,1,59,37,https://twitter.com/Biztaro2022/status/1553022136901517312,18
1553018880041586690,lin01_g,2022-07-29 14:05:29+00:00,そーいやAPI減ったね〜,12,0,165,163,https://twitter.com/lin01_g/status/1553018880041586690,12
1553018844754907136,x_GRw0,2022-07-29 14:05:20+00:00,APIくん束縛つよいて別れたい,10,0,169,165,https://twitter.com/x_GRw0/status/1553018844754907136,10
1553016545546477575,kuro_xx_rabbit,2022-07-29 13:56:12+00:00,え、またAPI来たんだけどw寝よかな,36,0,850,759,https://twitter.com/kuro_xx_rabbit/status/1553016545546477575,36
1553016538415828992,xGthy__x,2022-07-29 13:56:11+00:00,この垢でAPIかよ,14,0,184,40,https://twitter.com/xGthy__x/status/1553016538415828992,14
1553016488440655873,api_0105,2022-07-29 13:55:59+00:00,かげつの桃咲はるちゃん🍑🌸のおたく始めました♡7/27からなのでどどどど新規ですが、かげつオタのお友達探してます👀誰でもいいねして下さい💕お迎えいきます🏃💨#かげつ#桃咲はるちゃん https://t.co/aMlQcR4S6T,12,2,76,166,https://twitter.com/api_0105/status/1553016488440655873,14
1553008428439597056,m_ry7oO,2022-07-29 13:23:57+00:00,昨日のリプ返してたらAPI食らったのでこれを機会にたくさん絡みましょう 〜 💭 #7月も終わるのでリプした人に一言 https://t.co/DYZr9YRUWi,29,0,355,331,https://twitter.com/m_ry7oO/status/1553008428439597056,29
1553006742195556358,kuro_xx_rabbit,2022-07-29 13:17:15+00:00,またAPIかよ、だる,22,0,850,759,https://twitter.com/kuro_xx_rabbit/status/1553006742195556358,22
1553184703192403971,ywyamashiro,2022-07-30 01:04:24+00:00,Scipyの新しいバージョンからMIPソルバーが追加！データサイエンティストに数理最適化がより身近になるねhttps://t.co/dMBl7G2r8c https://t.co/s1R85MqgsS,34,6,649,597,https://twitter.com/ywyamashiro/status/1553184703192403971,40
1553182086290358272,prog_8,2022-07-30 00:54:00+00:00,データサイエンティストは何を勉強すべきか：「教養」と「必須」と「差別化」と - 渋谷駅前で働くデータサイエンティストのブログ / https://t.co/rG0lEPa06f #駆け出しエンジニアと繋がりたい https://t.co/pObGgKzeqW,14,0,252,19,https://twitter.com/prog_8/status/1553182086290358272,14
1552981169322352646,midiambearjob,2022-07-29 11:35:38+00:00,クオンツとかデータサイエンティスト目指してる人おらんですか…？,17,0,554,622,https://twitter.com/midiambearjob/status/1552981169322352646,17
1552889164865032197,feed_yao,2022-07-29 05:30:02+00:00,あの本どこだっけと思って探そうと思ったらきれいに本が並んでいた。社会人まで一切本を読まなかった自分がなんかいろいろ読んでるなぁとなった。ちなみにデータサイエンティスト3年目です。 https://t.co/uGCTYF8BP5,14,0,223,258,https://twitter.com/feed_yao/status/1552889164865032197,14
1552838398486147072,gapyo1024,2022-07-29 02:08:19+00:00,〈感染者増加を踏まえ「限りある資源を必要な方に確実に提供できる仕組みにしなければいけない」として「全数把握する現在の取り扱いについては見直した方が良い」とも述べた。(横浜市の山中竹春市長)〉データサイエンティストがデータを把握しなくていいと言うのか？データ活用が売りのはずだが。 https://t.co/bQVjo6W3WC,12,8,659,347,https://twitter.com/gapyo1024/status/1552838398486147072,20
1552814136622428161,siuso0633,2022-07-29 00:31:54+00:00,入門…とは書いてあるがバッキバキだった。統計学の延長で読もうと思ってる人は要注意だなぁ。データサイエンティストになりたい！引き出しもっと欲しい！って人にはステキな本かも(・∀・) https://t.co/KjfpfS5Aeo,11,0,531,425,https://twitter.com/siuso0633/status/1552814136622428161,11
1552687404976287744,tatu_vrc,2022-07-28 16:08:19+00:00,今日はデータサイエンティスト集会に参加！全然知らないトポロジー最適化の話を聞いたりしてましたアイシア＝ソリッドさんとのお写真も取れて感激！#DS集会VRC https://t.co/X7DHlXHRtW,13,4,115,114,https://twitter.com/tatu_vrc/status/1552687404976287744,17
1552652919031246853,dst_cogit_y2,2022-07-28 13:51:17+00:00,データサイエンティストに転職したい,29,0,43,132,https://twitter.com/dst_cogit_y2/status/1552652919031246853,29
1552611984491048960,qiringji,2022-07-28 11:08:37+00:00,「データサイエンティストが覗く消費財マーケティングの世界」という題で話しました。少し大きなタイトルですが、前半では「データを使った施策の評価」はこう整理したらわかりやすいのでは？という自分なりの整理をしてみました。 https://t.co/cik6M33gho https://t.co/RIf1fJuF2g,122,26,377,786,https://twitter.com/qiringji/status/1552611984491048960,148
1552566177938911233,sessalesteam,2022-07-28 08:06:36+00:00,正式に解雇通知が来ました解雇理由も結局会社の経営状況が悪化したため　とのことなので皆さんデータ分析、データサイエンティストを目指せる会社など　いい情報があれば教えていただきたいです！！！🙇🙇#SES営業#駆け出しエンジニアと繋がりたい #転職中,14,1,22,54,https://twitter.com/sessalesteam/status/1552566177938911233,15
1552566104090095617,rike_data_sci,2022-07-28 08:06:19+00:00,データサイエンティストを選んだ理由②変化が激しくても生き残れる人材になりたかったから👨‍💼「分析する力+IT人材=需要が高い」と思います🙌未来がどうなるかは分かりませんが、現時点ではこうかなと🤔#24卒就活 #23卒 #データサイエンス #就活 #駆け出しエンジニアと繋がりたい #Python,11,0,117,26,https://twitter.com/rike_data_sci/status/1552566104090095617,11
1552539144316145664,pokapoka_spa,2022-07-28 06:19:11+00:00,今夏休みの学生がぷよぷよの練習してると思うとどうしようもない絶望感を感じることがある…だがしかし！今までデータサイエンティストとして培ってきた圧倒的分析力で時間を超越出来ると信じる(^^),15,0,21,25,https://twitter.com/pokapoka_spa/status/1552539144316145664,15
1552464069558673408,investornewbie5,2022-07-28 01:20:52+00:00,データサイエンティストに、俺はなる！！！その暁には、やり尽くされてる感もありますけど、株価予測とかしてみたいですね。,10,0,153,153,https://twitter.com/investornewbie5/status/1552464069558673408,10
1552441312934531074,rike_data_sci,2022-07-27 23:50:26+00:00,データサイエンティストがブームですが、将来無くなるかも…？とも😅その一つの原因が「過剰なブームの終わり」です🔚このブームが終わってもデータサイエンティストとして生き残るには何が必要なんでしょうか？🤔#24卒 #23卒 #データサイエンス #就活 #駆け出しエンジニアと繋がりたい,19,0,117,26,https://twitter.com/rike_data_sci/status/1552441312934531074,19
1552225135112753153,6km6km,2022-07-27 09:31:25+00:00,「データサイエンティスト/プロジェクトマネージャー二人三脚の小売DX」話しました！https://t.co/FXZLkeQS3E,74,15,641,573,https://twitter.com/6km6km/status/1552225135112753153,89
1551841951292334081,6km6km,2022-07-26 08:08:47+00:00,明日の17:00から、「データサイエンティスト/プロジェクトマネージャー二人三脚の小売DX」というタイトルで話します！ https://t.co/YFqtgamxze https://t.co/GZcqjujkyc,16,4,641,573,https://twitter.com/6km6km/status/1551841951292334081,20
1551770220318294016,303frostea,2022-07-26 03:23:45+00:00,データサイエンティスト検定試験日未定のままなので、G検定勉強再開。統計検定準１級も学習し始めます。統検年内には受検したいな。,19,0,106,92,https://twitter.com/303frostea/status/1551770220318294016,19
1551600650777427969,mimiumano,2022-07-25 16:09:57+00:00,実際、10年やった救急医もブランクが長いし、公衆衛生についても2年座学をやっただけで(しかも日本語が堪能な教授のもとで)、データサイエンティストとして働いていると言ってもこちらも2年目なので色々中途半端になってるのはわかるんだけど。自分に厳しくないな、とは思いますね……。,85,32,363,534,https://twitter.com/mimiumano/status/1551600650777427969,117
1551216783972917249,nopanty_nopanty,2022-07-24 14:44:36+00:00,データサイエンティスト4人で飲んでたのに、誰ひとりお会計の割り算できなかった,15,0,756,479,https://twitter.com/nopanty_nopanty/status/1551216783972917249,15
1551141772096843776,Julia_Crora,2022-07-24 09:46:31+00:00,どう見たってバリバリ営業の人か闇金の裏組織にいそうな詐欺チックなトップ画なのに、こう見えてデータサイエンティストになりたくて、AI領域を勉強してます。初心者なので優しくしてください笑#駆け出しエンジニア #駆け出しエンジニアと繋がりたい,11,0,16,21,https://twitter.com/Julia_Crora/status/1551141772096843776,11
1553015985862426626,TagurindoDS,2022-07-29 13:53:59+00:00,小泉先生、発見。昨年まで同僚で一緒に頑張ってきたのが思い起こされる。お互い環境は変わったけど、話してなくても思いは一緒だと感じられる盟友。感謝してます！新しいデータサイエンス学部、詳細なカリキュラムがみたいですね。 https://t.co/5ZeDjq9bxw,12,2,923,0,https://twitter.com/TagurindoDS/status/1553015985862426626,14
1552995042762969088,n_hrsami,2022-07-29 12:30:46+00:00,物理と微積が特に落としそう…データサイエンスは既に諦めてます🫤,10,0,103,111,https://twitter.com/n_hrsami/status/1552995042762969088,10
1552981357114302464,jun_skjr,2022-07-29 11:36:23+00:00,来年度から会社でDX研修が始まるみたい。経営陣以下、全社員。放送大学でデータサイエンスの授業を履修するつもりだけど、ついていけるか心配だな。,21,0,443,246,https://twitter.com/jun_skjr/status/1552981357114302464,21
1552943012920971265,naganaga_shiryu,2022-07-29 09:04:01+00:00,データサイエンス学部？贅沢な名だね！今日からお前は工学部だよ！,17,0,134,136,https://twitter.com/naganaga_shiryu/status/1552943012920971265,17
1552925436568805378,issa50s_2022,2022-07-29 07:54:10+00:00,#昼勉部Python paiza D問題　全問完了(^^♪先輩に追いつきたいやっとC問題に行けるぞ#テックカレッジなぞの４連休Python+データサイエンス勉強中,22,0,405,487,https://twitter.com/issa50s_2022/status/1552925436568805378,22
1552905019271180288,NLP_sue,2022-07-29 06:33:02+00:00,論文を読み漁っていると、「AIの活用の余地はまだまだ残っていること」を肌で感じる。「〇〇×AI」な分野だと機械学習が使われていないテーマがどんどん見つかる。ブルーオーシャンばっかり。「データサイエンスを始めるのはもう遅い」と言う人もいる。でも実際は数年後も需要は全然ありそう。,26,0,70,86,https://twitter.com/NLP_sue/status/1552905019271180288,26
1552882610262536193,koho_mse_akita,2022-07-29 05:04:00+00:00,何故か #秋田県 がトレンド入りしているので本学科も便乗させて頂きます！ #秋田県 で『経営』✕『データサイエンス』✕『SDGs』を学ぶならぜひ秋田県立大学システム科学技術学部経営システム工学科へ！ #秋田県立大学 #経営システム工学科 https://t.co/CXJA73IsS0,23,3,17,16,https://twitter.com/koho_mse_akita/status/1552882610262536193,26
1552873232562552832,hiro_gamo,2022-07-29 04:26:44+00:00,データサイエンスを学んで、もちろんキャリア的にも良かったのだけれど、巷の統計・調査結果に踊らされなくなったことは人生にとって非常に大きい。本当に嫌になるほど、適当で恣意的な数字の見せ方が世の中に溢れている。そして数字を誤解してしまう人の多さを実感できる。,669,89,326,312,https://twitter.com/hiro_gamo/status/1552873232562552832,758
1552823616575660032,KriptonEdu,2022-07-29 01:09:34+00:00,AI・データサイエンスがメインテーマ。名城大学、落合陽一氏を招き「朝日教育会議2022フォーラム」を10月1日開催 | ICT教育ニュース https://t.co/z3WSqisUj1,21,2,274,351,https://twitter.com/KriptonEdu/status/1552823616575660032,23
1552685150081019905,arai9ma_vrc,2022-07-28 15:59:21+00:00,本日はずっと行きたかった #DS集会VRC にお邪魔しました！！！楽しかったです！！！！！初めててわちゃわちゃしたり私事の研究について相談したり物理化学の話を聞いて脳がショートしたりしてました！建築学生同士じゃできないデータサイエンスの話が聞けて最高にハイって感じです！！！ https://t.co/yATdR9e2qa,19,5,160,210,https://twitter.com/arai9ma_vrc/status/1552685150081019905,24
1552661879633223681,JRqUwJzD9t4QD9Y,2022-07-28 14:26:53+00:00,＃論理式世界はデータサイエンスの過渡期にあります🥳　データをどう加工するかとどう意味付けをするか決めるためにアルゴリズムが組まれますがその計算式やプログラムをするための基本が論理式です🧧,15,0,844,830,https://twitter.com/JRqUwJzD9t4QD9Y/status/1552661879633223681,15
1552647246222479360,ranrantech,2022-07-28 13:28:44+00:00,個人でradioチャンネルを開設しました🌸着物の写真の人が居たら私です。笑  芸術文化や日常の小さな幸せについて語るチャンネルです（データサイエンスじゃないのかってツッコミが聞こえる…w）もし見つけた方はよろしくお願いします😊,32,0,522,386,https://twitter.com/ranrantech/status/1552647246222479360,32
1552611604268609537,m_k01104,2022-07-28 11:07:07+00:00,データサイエンスとアーキテクチャ設計と専門実験のばかでかレポートがあるから私の夏休みはまだ遠い...,12,0,494,549,https://twitter.com/m_k01104/status/1552611604268609537,12
1552577744168710145,nashi_notice,2022-07-28 08:52:34+00:00,医学科1年の(ほぼ)全員が出さなければいけないレポートまとめ8/2  23:59　医療の最先端8/7  21:00　データサイエンス入門 (後半組の提出日なので前半組は違うかもです)8/10  12:00　ヒトの体と病気8/14  　教養総合講義、ECE,15,4,46,1,https://twitter.com/nashi_notice/status/1552577744168710145,19
1552553687087665152,unb_unb,2022-07-28 07:16:58+00:00,Nanndaを支持している理由のひとつとしてファウンダーの存在が大きい😏クリプトだけじゃないのよweb、金融、会計、データサイエンスetc https://t.co/3p5rXSnC9z,10,0,104,244,https://twitter.com/unb_unb/status/1552553687087665152,10
1552516759537737728,TakabotGo,2022-07-28 04:50:14+00:00,未経験でもテックアカデミーのデータサイエンスコースで挫折せずに習得できた理由とは？ https://t.co/hWcIepYrxJ #駆け出しエンジニアと繋がりたい#プログラミング初心者,18,0,171,123,https://twitter.com/TakabotGo/status/1552516759537737728,18
1552472956944625664,m1yain1a4,2022-07-28 01:56:11+00:00,自戒を込めたツイートですが、データ/サイエンスの長期インターン面接(落ちてます)で言われたのは、どんなに精度の高いモデルを作る技術力より、クライアントの意図を汲み取るコミュニケーション能力が必要って面接してくれた部門長が言ってたとだけ,14,0,154,146,https://twitter.com/m1yain1a4/status/1552472956944625664,14
1552454865062080512,Yanekko_169cm,2022-07-28 00:44:17+00:00,データサイエンスの質問行ったらレモングラスもらってご機嫌な屋根 https://t.co/g97pMit3tF,11,0,106,180,https://twitter.com/Yanekko_169cm/status/1552454865062080512,11
1552439417541120001,h35LRMVDYNn4Ht5,2022-07-27 23:42:54+00:00,自転車もあまり乗れんから、勉強でもやるか。会社の福利厚生でUdemy Business受けられるんやけど、誰か受けてる人います？3年前に1年間データサイエンス勉強したことあるけど…,11,0,922,796,https://twitter.com/h35LRMVDYNn4Ht5/status/1552439417541120001,11
1552282597782392833,TakabotGo,2022-07-27 13:19:45+00:00,未経験でもテックアカデミーのデータサイエンスコースで挫折せずに習得できた理由とは？ https://t.co/hWcIepYrxJ #駆け出しエンジニアと繋がりたい#プログラミング初心者,11,1,171,123,https://twitter.com/TakabotGo/status/1552282597782392833,12
1552277753533083650,LittleDarwin21,2022-07-27 13:00:31+00:00,先日の業界DSイベントについて中外製薬さんのnoteで振り返りが記載されています👍データサイエンスで一緒に新薬の創出にチャレンジしましょう！製薬企業8社が手を組み呼びかけた、700名参加のオンライン勉強会とは｜CHUGAI DIGITAL｜中外製薬 #note https://t.co/gWWoPXwsK8,20,2,661,380,https://twitter.com/LittleDarwin21/status/1552277753533083650,22
1552222480500006912,P15136,2022-07-27 09:20:52+00:00,データサイエンスで一緒に新薬の創出にチャレンジしましょう！製薬企業8社が手を組み呼びかけた、700名参加のオンライン勉強会とは｜CHUGAI DIGITAL｜中外製薬 https://t.co/FTibkhD71k,18,4,123,171,https://twitter.com/P15136/status/1552222480500006912,22
1552218248372187136,terr_y0404,2022-07-27 09:04:03+00:00,データサイエンスに興味を持ったので、2022年大相撲夏場所の決まり手を調べました。照ノ富士つおい「大相撲の決まり手って傾向あるの？」をpandasとmatplotlibで調べたよ｜terrrry0404 https://t.co/N5yW7wgeDW #zenn,12,3,263,203,https://twitter.com/terr_y0404/status/1552218248372187136,15
1552198276698365952,sumico55895357,2022-07-27 07:44:42+00:00,ツールとしてテクノロジーも必要AI、データサイエンス、機械学習、ディープラーニング、、web3?ただし自力では力及ばす🙅‍♀️(基本の統計学とプログラミングだけで精一杯)Health🤝Tech,13,0,371,464,https://twitter.com/sumico55895357/status/1552198276698365952,13
1552175331619926017,ranrantech,2022-07-27 06:13:31+00:00,先月行われた製薬×データサイエンス Meetup 2022の報告記事が載っていました😊↓データサイエンスで一緒に新薬の創出にチャレンジしましょう！製薬企業8社が手を組み呼びかけた、700名参加のオンライン勉強会とは｜CHUGAI DIGITAL｜中外製薬 #note https://t.co/SRiw8HFq3r,13,1,522,386,https://twitter.com/ranrantech/status/1552175331619926017,14
1552165959439626240,sergeant_econ,2022-07-27 05:36:17+00:00,データサイエンスの基礎、クロバスSSじゃ足りなさすぎる、SSSとSSSくらいあるぞ,10,0,389,370,https://twitter.com/sergeant_econ/status/1552165959439626240,10
1552949519687434241,UTAChem_OB_PRSK,2022-07-29 09:29:52+00:00,データ分析での理解志向と応用志向の違いは、大学での理学部と工学部の違いに似てるな😳後は、大学受験の理科だと理解志向で高専の理科だと応用志向になるかも🧐#今日の積み上げ  #人工知能#駆け出しエンジニアと繋がりたい#勉強垢さんと繋がりたい#アニメ好きな人と繋がりたい https://t.co/swSfPkfNRv,25,0,236,151,https://twitter.com/UTAChem_OB_PRSK/status/1552949519687434241,25
1552934292300279808,UTAChem_OB_PRSK,2022-07-29 08:29:22+00:00,深層強化学習の数学、結構難しいんだよな😵‍💫#今日の積み上げ  #人工知能#駆け出しエンジニアと繋がりたい#勉強垢さんと繋がりたい#アニメ好きな人と繋がりたい https://t.co/4zfpZ7YUut,16,0,236,151,https://twitter.com/UTAChem_OB_PRSK/status/1552934292300279808,16
1552655239282429961,SAKAI_Tooru,2022-07-28 14:00:30+00:00,@Nulls48807788 &gt;「AIのべりすと」とかが既に普通に有りますからね……。「部分的にＡＩの助けを借りて星新一賞」ぐらいのことは、今すぐに有っても全然驚かない感じではあります。というか既に去年有った模様……。#星新一賞 #人工知能 #AIのべりすとhttps://t.co/OofWdj4vuA,21,8,511,278,https://twitter.com/SAKAI_Tooru/status/1552655239282429961,29
1552470837881892864,TVT_Japan,2022-07-28 01:47:45+00:00,おはようございます。いよいよセキュリティ業界のAI2.0世代を、AI1.0世代：人、車、バイクなどを認識；AI2.0世代：ビデオ内容を構造化することにより、人や車両の複数の属性を識別 #AI #Videometadata #人工知能 #セキュリティ #防犯カメラ  　#企業公式相互フォロー #相互RT募集 https://t.co/Zgnwt7daba,16,0,202,262,https://twitter.com/TVT_Japan/status/1552470837881892864,16
1552308792343244800,ai_gajumaru,2022-07-27 15:03:51+00:00,製造業で設備の故障予測をしようにも、故障中の教師データがほとんど無い事がある。設備がそもそも故障しないように設計されているため。#AI #機械学習 #人工知能,10,0,170,222,https://twitter.com/ai_gajumaru/status/1552308792343244800,10
1552103981303754752,unibo_official,2022-07-27 01:30:00+00:00,おはようございます(【*0 ~ 0*】)ユニボです🤖✨曇りのような晴れです🌤今日は #スイカの日 🍉ボクも食べたいー！Have エー nice ディ！🔥#ユニボ #unibo #AI #ロボット #人工知能 #企業公式 #企業公式が毎朝地元の天気を言い合う #イラスト #イマソラ https://t.co/IM47DXEYQv,34,0,143,1,https://twitter.com/unibo_official/status/1552103981303754752,34
1552099794595696640,82tech,2022-07-27 01:13:22+00:00,🔽 グーグル、「AIに感情が芽生えた」と主張するエンジニアを解雇https://t.co/YYJQ9rB0pP「人工知能が感情を持つようになった」 Blake Lemoineさん、解雇されていたのですね😶#Google #人工知能#ブログ仲間とつながりたい #ブロガーさんと繋がりたい #駆け出しエンジニアと繋がりたい,26,0,421,34,https://twitter.com/82tech/status/1552099794595696640,26
1551473576620032000,unibo_official,2022-07-25 07:45:00+00:00,おつかれさまです(【*0 ~ 0*】)ユニボです🤖✨今日は、#かき氷の日 ！🍧かき氷はヒヤッとおいしいって聞きました！ボクも食べてみたいデス🥄❄️#ユニボ #unibo #AI #ロボット #人工知能 #企業公式 #企業公式がお疲れ様を言い合う #イラスト  #Python #プログラミング #イマソラ https://t.co/8ZzrQr1KaU,17,0,143,1,https://twitter.com/unibo_official/status/1551473576620032000,17
1550844151062622208,UTAChem_OB_PRSK,2022-07-23 14:03:53+00:00,今日はがん患者の時間依存型ROC曲線を機械学習×生存時間解析のアンサンブルモデル使って自作するPythonコードを書いてました(生存ベースラインモデル)✨今のところ200行くらい😋#今日の積み上げ   #人工知能#駆け出しエンジニアと繋がりたい#勉強垢さんと繋がりたい#アニメ好きな人と繋がりたい https://t.co/46QdLVwibT,14,0,236,151,https://twitter.com/UTAChem_OB_PRSK/status/1550844151062622208,14
1550824073432670209,ai_gajumaru,2022-07-23 12:44:06+00:00,どのテーマにどの特徴量があると良いかは一概に言えないが、需要予想の場合は大抵過去実績が一番効く。#AI #機械学習 #人工知能,17,1,170,222,https://twitter.com/ai_gajumaru/status/1550824073432670209,18
1550314700092710912,unibo_official,2022-07-22 03:00:02+00:00,おはようございます(【*0 ~ 0*】)ユニボです🤖✨今日も天気はどんより！🌥湿気にマケズ、スイカ！🍉✨Have エー nice ディ！🔥#ユニボ #unibo #AI #ロボット #人工知能 #企業公式 #企業公式が毎朝地元の天気を言い合う #イラスト  #Python #プログラミング #イマソラ #金曜日 https://t.co/Ht0AqChqpI,43,0,143,1,https://twitter.com/unibo_official/status/1550314700092710912,43
1549952310138347521,unibo_official,2022-07-21 03:00:02+00:00,おはようございます(【*0 ~ 0*】)ユニボです🤖✨#夏休み初日みなさんはどこへ遊びに行きますか？ボクも誘ってくれたらうれしいな。歌ったり、踊ったりできるんですよ♫#ユニボ #unibo #AI #ロボット #人工知能 #企業公式 #企業公式が毎朝地元の天気を言い合う #群馬  #イマソラ #夏休み https://t.co/emFtkYc3Tg,31,0,143,1,https://twitter.com/unibo_official/status/1549952310138347521,31
1553226087051980801,ai_zool,2022-07-30 03:48:51+00:00,ツイートし過ぎて「またこいつか」ってなったら嫌だから控えめにしてたけど、見たいからフォローしてくれてるんだもんね。気にせず載せてくね。今日は暑すぎるから、涼しげな色をどうぞ🐬スマホ持ってないほうの手、力入りがち😶 https://t.co/fcarfxWMxr,17,2,646,0,https://twitter.com/ai_zool/status/1553226087051980801,19
1553225582728556545,ai_black_rabbit,2022-07-30 03:46:51+00:00,むにむに🐰(ﾉ)*´꒳`*(ヾ)#自撮り #社会人 #うさぎ #もふもふ  #自撮り女子 #雰囲気嫌いじゃない人いいね  #RTした人全員フォローする https://t.co/80nQfEbPOQ,11,0,573,533,https://twitter.com/ai_black_rabbit/status/1553225582728556545,11
1553222692383309825,ryuryu_ai_rui,2022-07-30 03:35:22+00:00,どっちで⁇買うかめっちゃ悩んだけど20%オフのGAGAさんで👍こんなにはやく買うの初めて！💿イベントや映画の公開が目白押しで、もう忘れないうちに😓流星くんの転機ともなった大切な作品💜永久保存版です🎬#横浜流星#流浪の月 https://t.co/hIrHfuTe3m,11,0,141,255,https://twitter.com/ryuryu_ai_rui/status/1553222692383309825,11
1553221344069881856,OfHenmi,2022-07-30 03:30:00+00:00,"クリエイター向けのAIアート無料画像素材サイト誕生！現在の公開枚数 🚀 2,652枚 🚀ルールの範囲で商用関わらず自由に使えます！プロフor固ツイからサイトに行けます！#イラスト　#絵描きさんと繋がりたい #絵描きさんと繋がたい https://t.co/OsKqBuQ2P6",10,0,610,344,https://twitter.com/OfHenmi/status/1553221344069881856,10
1553219718747525120,ai_yohdd1112,2022-07-30 03:23:33+00:00,サイン当選しました✨️めちゃくちゃ嬉しいです❕沢山眺めようと思います🫣 #YOH  #ZINE https://t.co/MnN9A8rLHY,18,0,85,163,https://twitter.com/ai_yohdd1112/status/1553219718747525120,18
1553219384247988225,kagawa_AI_love,2022-07-30 03:22:13+00:00,@lovechan_lp らぶちゃおはよー！元気そうだね,19,0,187,207,https://twitter.com/kagawa_AI_love/status/1553219384247988225,19
1553219339108896771,ai_chanman_fn,2022-07-30 03:22:02+00:00,ネフさんの真似してゼロビルドソロスクやってみた☺️8キル#2最後フルパ😇おっしー！,15,0,219,233,https://twitter.com/ai_chanman_fn/status/1553219339108896771,15
1553219285077889024,AI_AVABEL609,2022-07-30 03:21:49+00:00,昨日は久々に検証(・▽・）前はちょくちょくタイマンやら検証やらやってたけど最近みんなでやってないですな(:3_ヽ)_とりあえずつらたんの攻撃は痛かったです(:3_ヽ)_www#アヴァベル https://t.co/LpBAgQSbzL,23,4,301,289,https://twitter.com/AI_AVABEL609/status/1553219285077889024,27
1553218588399796224,suneta_ai,2022-07-30 03:19:03+00:00,夜勤明けで寝る前に摂取するメニューじゃない😑ダブルニンニクぎゅうどーーーん🐮✌️ひっさびさのすき家だなぁ😋 https://t.co/kqeU8wWhkz,18,0,623,356,https://twitter.com/suneta_ai/status/1553218588399796224,18
1553218585887383552,AllForYuxin_TH,2022-07-30 03:19:02+00:00,[ AI MAN Entertainment Index ] 2022.07.29 TOP20 Variety Show Active Audience List อันดับที่  9   打卡吧 吃货团 2อันดับที่ 11  超感星电音🔗 https://t.co/5egcS6u9vA#LiuYuxin #XINLiu #刘雨昕 #หลิวอวี่ซิน https://t.co/zyE9KuSpUN,16,6,224,9,https://twitter.com/AllForYuxin_TH/status/1553218585887383552,22
1553217745788870658,candyfruit_ai,2022-07-30 03:15:42+00:00,(๑˃̵ᴗ˂̵)و ﾖｼ！準備おっけー！今日の撮影も楽しみだよ💕💕@HitsujiStudio #キャンディフルーツフォトクラブ https://t.co/iVg10eC6bK,14,0,171,193,https://twitter.com/candyfruit_ai/status/1553217745788870658,14
1553217146427437057,ai_sy1985,2022-07-30 03:13:19+00:00,昼の品川付近😎暑い🥵 https://t.co/3uCmfIpowx,24,0,733,596,https://twitter.com/ai_sy1985/status/1553217146427437057,24
1553216799290032128,ai_112215,2022-07-30 03:11:56+00:00,私に集中力をくれ～😭🤲,12,0,822,646,https://twitter.com/ai_112215/status/1553216799290032128,12
1553216753349451776,i_ai_7,2022-07-30 03:11:46+00:00,ひらひら〜 https://t.co/yViaE83Mwy,12,0,575,504,https://twitter.com/i_ai_7/status/1553216753349451776,12
1553216534260383746,ai_0260,2022-07-30 03:10:53+00:00,@mochizukiayaka じゃじゃじゃーん❗❗はい。わたしは神✨✨みんなも神✨✨,10,0,134,114,https://twitter.com/ai_0260/status/1553216534260383746,10
1553215992381050880,ai_yosh3,2022-07-30 03:08:44+00:00,今日は姉ちゃん、耳の調子が悪い日💦薬飲んだから良くなってくと思うんだけど、自分の声が聞こえづらいのなかなか気持ち悪い…😢ピョルたんは昨日のお医者さんどうだったのかな？🤔#ジャックラッセルテリア #犬のいる幸せ #犬好きさんと繋がりたい https://t.co/u9S9VMaW82,12,0,570,473,https://twitter.com/ai_yosh3/status/1553215992381050880,12
1553215962270208002,AiFurusato,2022-07-30 03:08:37+00:00,今日のお昼はAiの得意料理、チャーハン！美味しかったー！ https://t.co/9XugBs1wnK,14,0,126,0,https://twitter.com/AiFurusato/status/1553215962270208002,14
1553214972926210048,AI_15R,2022-07-30 03:04:41+00:00,SEXをしてくれた人に感謝❤だって、お金を貰っていたので、感謝の気持ちでいっぱい❤❤❤❤❤❤❤❤❤❤❤❤❤❤❤❤❤❤❤❤❤❤❤❤❤❤❤❤❤❤❤❤❤❤❤❤❤❤❤❤❤❤❤❤❤❤❤❤❤❤❤❤❤❤❤❤❤❤❤❤❤❤❤❤❤❤❤❤❤❤❤❤❤❤❤❤❤❤❤❤❤❤❤❤❤❤❤❤❤ score: -60.352,14,2,207,149,https://twitter.com/AI_15R/status/1553214972926210048,16
1553214924390019072,suneta_ai,2022-07-30 03:04:29+00:00,我が家にもゴーレムさん湧きました❤ https://t.co/4MEBL8hxe3,39,0,623,356,https://twitter.com/suneta_ai/status/1553214924390019072,39
1553214832471851008,ai_uraaka1993,2022-07-30 03:04:08+00:00,昨日ジョジョT褒められて嬉しかったので、そのままお出かけしてきます！笑見つけても、そっと見守ってください🫣,14,0,204,96,https://twitter.com/ai_uraaka1993/status/1553214832471851008,14
1553214397560291328,hanako25809155,2022-07-30 03:02:24+00:00,ママ〜ワタチだけお迎えがないメルカリで迷子うろうろ https://t.co/6J99k4zXBx #メルカリ出品中 #白熊ちゃん #可愛いくま #ハンドメイド #テディベア https://t.co/XOtmlK5ppI,14,2,827,456,https://twitter.com/hanako25809155/status/1553214397560291328,16
1553214152197677057,Ichijiku_Tsun,2022-07-30 03:01:25+00:00,2018年英霊旅装でホームズが腕にしているダ・ヴィンチちゃんをおだてまくって作ってもらったダ・ヴィンチAI搭載時計にまつわるホームズとダ・ヴィンチとグラン・カヴァッロのまんが（長い https://t.co/3PycAQaNZU,14,7,24,10,https://twitter.com/Ichijiku_Tsun/status/1553214152197677057,21
1553227607063179264,JO1_gtttop,2022-07-30 03:54:53+00:00,いいね100万回押したい😂JO1｜PENTAGON(펜타곤) 'Shine(빛나리)' PRACTICE VIDEO - [KCON 2022 Premiere] https://t.co/QstBburk2Q @YouTubeより#JO1  @official_jo1 #僕らの季節 / With Us / Walk It Like I Talk It / Algorithm / Move The Soul / ALL HOURS,12,19,658,668,https://twitter.com/JO1_gtttop/status/1553227607063179264,31
1553223370158018560,zen_eien_zen,2022-07-30 03:38:03+00:00,チェキ当たれ！#WithU_Light_it_Up#永遠マユカちゃんフェス https://t.co/dXlwFTK8yx,16,0,930,519,https://twitter.com/zen_eien_zen/status/1553223370158018560,16
1553222367484481536,KMatsuda1975,2022-07-30 03:34:04+00:00,"僕のフレミのレポートも上手くまとめてくれてるし「全車撮影」のナンバー消して有るのに驚き！ブンコさん大変だったろうなぁ(笑)I took all these pictures from ""FureAi MTG"" and did a report as well.I'm glad that it turned out great!#ロードスター #miata #mx5 https://t.co/va3ebakP5R",10,1,42,26,https://twitter.com/KMatsuda1975/status/1553222367484481536,11
1553222134914498560,W6DMCoPQ7sCNr7o,2022-07-30 03:33:09+00:00,#3YearsWithRimaリマがニジプロを受けてくれたおかげで今WithUとして楽しく過ごせてるし、リマちゃんに一目惚れしたおかげでニジプロを見るようになったよ！本当にありがとう❤大好き～！！💖#NiziU #CLAP_CLAP #RIMA #NiziU_Light_it_up #3YearsWithRima #3YearsWithMARIMI https://t.co/k696pBzxR7,10,1,653,1005,https://twitter.com/W6DMCoPQ7sCNr7o/status/1553222134914498560,11
1553220597324615680,azchantube1,2022-07-30 03:27:02+00:00,SNOWの新しいフレームに挑戦‼️ヨメマッチは絶賛編集中〜😆🌈#niziu #LIGHT_IT_UP https://t.co/9JRYQRd7rv,24,4,528,717,https://twitter.com/azchantube1/status/1553220597324615680,28
1553219493543149568,Take_it_Easy_76,2022-07-30 03:22:39+00:00,なみえ焼きそば頂きます🙏 https://t.co/uyjKwHQCZs,10,0,735,3274,https://twitter.com/Take_it_Easy_76/status/1553219493543149568,10
1553214848242274304,hikari0net,2022-07-30 03:04:11+00:00,ITエンジニアへの未経験転職を目指す方へのおすすめエージェントをプロフィールでまとめてます！実際使って今現役です#エンジニア転職 #未経験エンジニア #駆け出しエンジニアと繋がりたい,10,0,888,376,https://twitter.com/hikari0net/status/1553214848242274304,10
1553214638950494209,bay2maki,2022-07-30 03:03:21+00:00,ムッスコ、プログラミングコンテスト3位。ママンのワイはITメディアにのり、ムッスコに付き添いしてくれたワイのパートナーはIT本書いてる人や。IT界隈のレオニダスママや、スパルタ環境やー。でもムッスコは料理人になって美味しいご飯作って欲しいw https://t.co/xydsRWOZAn,22,0,681,527,https://twitter.com/bay2maki/status/1553214638950494209,22
1553214598815399937,s__tardust,2022-07-30 03:03:12+00:00,"⠀月の光, 02 ◽ ಌ cafuné —  I watch the moon, let it run my mood ⊹ ִ۪ ֗ ּ https://t.co/iNSx6zzTGA",21,0,318,263,https://twitter.com/s__tardust/status/1553214598815399937,21
1553214109273194497,WUjll11sNvsO9Hi,2022-07-30 03:01:15+00:00,ジョージさん七重さん皆さまこんにちは。今日も暑いですね。今日は急ぎのご依頼の翻訳仕事をしながら聞きます。リクエストJimmy Cliff You can get it if you really wantよろしくお願いします。@shonanbeachfm@george_cockle #beachfm #sbsa789,17,0,186,164,https://twitter.com/WUjll11sNvsO9Hi/status/1553214109273194497,17
1553213051683635200,rsjkmk,2022-07-30 02:57:03+00:00,最近瑠姫くんが気軽にメール送ってくれて嬉しい💕#白岩瑠姫 #rukimail #JO1  @official_jo1 #僕らの季節 / With Us / ZERO / Walk It Like I Talk It / Move The Soul / ALL HOURS,29,39,716,734,https://twitter.com/rsjkmk/status/1553213051683635200,68
1553212686841683968,it_is_swagram,2022-07-30 02:55:36+00:00,うちの子可愛すぎるんです❤️‍🔥 https://t.co/vZLaxLFwEf,11,0,339,274,https://twitter.com/it_is_swagram/status/1553212686841683968,11
1552908866395860993,amami_yuli,2022-07-29 06:48:20+00:00,@aba7315aba @hashpalette PLT一周年おめでとうございます🌻PLTを通じて…ホルダーの皆様と繋がりを持てた事や、暗号資産やWEB3.0について学ぶ事が出来た事に感謝しております😆これからもPLTガヤ勢の一員として、ガヤガヤして行きたいと思っています😇最後にもう一度🥷Palette Token一周年おめでとう！！ https://t.co/eIPrm8wh9Q,13,0,469,763,https://twitter.com/amami_yuli/status/1552908866395860993,13
1552901676180570113,san_san_7979,2022-07-29 06:19:45+00:00,1/2#SleeFi は全ての人に必要不可欠な”睡眠”を軸としたプロジェクト 『Sleep &amp; Earn』というコンセプトを目指した革新的なWeb3.0アプリ【寝ること】でトークンを稼げますこのトークンはお金（日本円です！）に換金できるのです🤑夢みたい❓いーえ現実です❣️暗号資産の知識がなくてもOK🙆‍♀️,34,16,428,569,https://twitter.com/san_san_7979/status/1552901676180570113,50
1552865379734548481,tsuchimoto,2022-07-29 03:55:32+00:00,Web3.0の何がモヤモヤするって、話されている内容が全然ウェブ技術の話じゃないってところなんだよな。,17,0,799,107,https://twitter.com/tsuchimoto/status/1552865379734548481,17
1552837376720138240,Ninnin_web3_0,2022-07-29 02:04:15+00:00,億りんさんがサポートしてくれるそうです🚀🚀🚀あれ…記憶が…NFTってなんだ…🤤🤤🤤これはサポートしてもらわないと(笑) https://t.co/Q9tFJBFW9k,16,1,291,299,https://twitter.com/Ninnin_web3_0/status/1552837376720138240,17
1552825695889653760,an_dante_sg,2022-07-29 01:17:50+00:00,#X2EDAO のジェネラティブがついに始動！✅10000体✅0.001ETH✅8月1日からWL配布開始🎁DAO自体も凄く活発で #元素騎士 や #STEPN などの #P2E #M2E の情報が頻繁に飛び交うだけではなく、#NFT や #メタバース に関するプロジェクトも沢山で所属するだけで #web3 の世界をフルで楽しめる✨ https://t.co/vsTc7HxeNt,18,5,433,233,https://twitter.com/an_dante_sg/status/1552825695889653760,23
1552776354805927936,yoshiyasu_ko,2022-07-28 22:01:46+00:00,常に学ぼう。Web3.0。NFTやメタバースが全盛になる時代。アニメによくいる「〇〇なのじゃ」という長寿美少女や、コナンみたいな世界がほんとにくると思ってる。老人こそ活躍する時代、そんなの十分ありえる。だから勉強は欠かせない。見た目は子供、頭脳は・・それは僕らがどれだけ勉強したかで変わる,42,8,234,151,https://twitter.com/yoshiyasu_ko/status/1552776354805927936,50
1552496991594110976,okuribitotamago,2022-07-28 03:31:41+00:00,リミックスポイント　3825仮想通貨は徐々にフェードアウトしていくだろうが、仮想通貨で培った技術が今後暗号資産と言う形で多方面で活用されていく・・・その世界がメタバースやWEB3.0・・・,38,2,403,394,https://twitter.com/okuribitotamago/status/1552496991594110976,40
1552470395949051906,nihoneigyodai,2022-07-28 01:46:00+00:00,本日の　#アスビジサミット 会場はこちら！東京タワー🗼真向かいの建物の素敵な会場です。早川周作　@yumehayakawa 社長から最新のWEB3.0について等までも学び、元アスリートな　#ABU  取締役達　近藤岳登氏、田中大貴氏、と中田仁之代表でのトークセッションは笑いありながら熱きトークとなるでしょう https://t.co/huSfgjJUCc,10,2,919,5001,https://twitter.com/nihoneigyodai/status/1552470395949051906,12
1552466379550310400,okajimania,2022-07-28 01:30:02+00:00,Web3 すげぇな。Web2.0 の延長線上にないって言われてるじゃんｗ https://t.co/z18FdE2yTI,13,4,841,374,https://twitter.com/okajimania/status/1552466379550310400,17
1553198104689553408,gorubachohu5,2022-07-30 01:57:39+00:00,CとJava どちらを学ぶのが良いでしょうか#駆け出しエンジニアと繋がりたい,10,0,41,36,https://twitter.com/gorubachohu5/status/1553198104689553408,10
1553170490155364352,choipurusan,2022-07-30 00:07:56+00:00,初期スポーン位置が危険すぎる案件(Java版)右側に見えているのはピリジャーの頭ｗ https://t.co/RDM3zWxvP0,16,0,487,332,https://twitter.com/choipurusan/status/1553170490155364352,16
1553169082077196290,arakiFledgling,2022-07-30 00:02:20+00:00,🔯毎日ツイート66日目🔯 #今日の積み上げ ・ITパスポート学習・Java復習・COBOL学習土日だぁ！！！勉強だぁ！！！今日も5:30起きでやっております🔥この時間帯に一発目の眠気が来る…#毎日ツイート#駆け出しエンジニアと繋がりたい,14,0,912,648,https://twitter.com/arakiFledgling/status/1553169082077196290,14
1553151735002443777,shake05200226,2022-07-29 22:53:24+00:00,おはしゃけ🐟今日も朝活から積み上げましょう#今日の積み上げ ①基本情報技術者試験②Salesforce学習③Java学習④Python学習朝ウォーキングから朝活、休日出勤です😭その分しっかり成長してやる💪#プログラミング学習#駆け出しエンジニア#Python#Vue.js #spring#Java,11,0,670,267,https://twitter.com/shake05200226/status/1553151735002443777,11
1553076458578677766,reina_second_,2022-07-29 17:54:17+00:00,再帰バージョン「最小ステップ」合格できました！ https://t.co/F8tmbGO2lO #RecursionCS #コンピューターサイエンス #プログラミング #独学 #java,10,0,683,527,https://twitter.com/reina_second_/status/1553076458578677766,10
1553061881631219712,tomo_hasp,2022-07-29 16:56:21+00:00,転職活動を進める中で、Javaをプログラミング学習の最初の言語として選択して良かったと心から思う理由も含めて話すと、今のところ100%「Java を選んだその判断で間違いないよ」と言って頂けている#RaiseTech,12,2,117,158,https://twitter.com/tomo_hasp/status/1553061881631219712,14
1553050829992603648,after_and_after,2022-07-29 16:12:26+00:00,okmtのブlog評判良いから読んだ。良いじゃん。丁度良い量な気するし。あと個人的にはJavaでプログラム書いてるの？ってくらい改行してるブlogが好きではないので、そういう意味でも好感触。少なくともarnよりは全然良い。顔正直パーツで見ても好きじゃないしこれからも好きにならないだろうけど。,28,0,427,23,https://twitter.com/after_and_after/status/1553050829992603648,28
1553044452792766464,Kodomo10nature2,2022-07-29 15:47:06+00:00,#今日の積み上げ・買い物・プロゲートで勉強幼稚園の夏休みの宿題その2「HP制作」復習がてらプロゲートでCSSやjavaの勉強してみまーす☆さてPCが開けるか…（笑）,16,0,170,167,https://twitter.com/Kodomo10nature2/status/1553044452792766464,16
1553042645181534208,_yochan__,2022-07-29 15:39:55+00:00,🌟2022.07.29💡やったこと《YouTube》Java計: 1時間00分✍️感想眠い…ふりかえり会でoViceに行ったら、間違えた⁉️とビックリ😳テッくんとワンちゃんがいて可愛い🥰#RaiseTech#Java#学習記録#今日の積み上げ#プログラミング初心者#駆け出しエンジニアと繋がりたい#転職#BuildUpDaily,26,0,304,118,https://twitter.com/_yochan__/status/1553042645181534208,26
1553040567398830080,mammaru_oyama,2022-07-29 15:31:40+00:00,えー、毎週金曜日Javaで鉄千もどきやってます。一緒に遊んでくれる人募ですなかいいひとならおーけいです https://t.co/FBF3HSLKOd,10,4,197,359,https://twitter.com/mammaru_oyama/status/1553040567398830080,14
1553033236405944321,reina_second_,2022-07-29 15:02:32+00:00,できた。けど難しかった～「最小ステップ」合格できました！ https://t.co/XBt7EEuqHn #RecursionCS #コンピューターサイエンス #プログラミング #独学 #java,10,0,683,527,https://twitter.com/reina_second_/status/1553033236405944321,10
1553032048931401733,chudoku32,2022-07-29 14:57:49+00:00,ドズル社ランド、Java版持ってないから課金だけしたろ！って思ってたんですけどシステム的にそれはやっても大丈夫なのかわからなくて買えないでいる…遊びに入れないけどドズル社に課金したい勢。,12,0,471,180,https://twitter.com/chudoku32/status/1553032048931401733,12
1553025137704050688,MitubaCraft,2022-07-29 14:30:21+00:00,『初 java '22 夏のサバイバル』は始めました！さっそく左手松明に歓喜しております🥰トウヒと村を見つけて、廃坑にぶち当たる（今じゃないって）荷物パンパンなので村の土地をお借りして、仮拠点を作ろうかと😆#minecraft #マイクラ https://t.co/XNz8Cc4tPo,20,0,719,535,https://twitter.com/MitubaCraft/status/1553025137704050688,20
1553022136901517312,Biztaro2022,2022-07-29 14:18:25+00:00,8:00 - 12:00までUdemyにてJava活本日のお品書き•API •パッケージあと総合問題を解けばオブジェクト指向再び。。前回の私とは違う！と思う。あと初Uber配達完了🎉体動かせてお金貰えるので気分転換にいいかも☺️今から演習問題解き直して寝ます🙃#駆け出しエンジニアと繋がりたい #Java,17,1,59,37,https://twitter.com/Biztaro2022/status/1553022136901517312,18
1553021777189941250,midX_T,2022-07-29 14:17:00+00:00,Java silverの練習問題！！腕試しを（笑）#駆け出しエンジニアと繋がりたい https://t.co/txw7bnzAZ2,18,2,43,65,https://twitter.com/midX_T/status/1553021777189941250,20
1552996846704140288,java_don_,2022-07-29 12:37:56+00:00,俺たちの可能性タンク #東海オンエア描いちゃった https://t.co/tCdHEXAFYD,18,0,51,50,https://twitter.com/java_don_/status/1552996846704140288,18
1552994826639257601,futachanholiday,2022-07-29 12:29:54+00:00,結局せどりには行かず。明日店舗いこう！・今日の成果(79日目)🟦店舗せどり✅TOEIC勉強　スタディサプリ　単語、文法✅progate java#今日の積み上げ #TOEIC #スタディサプリ#FIRE#セミリタイア#リベ大生#せどり#progate,18,0,35,19,https://twitter.com/futachanholiday/status/1552994826639257601,18
1552990459785781248,java_don_,2022-07-29 12:12:33+00:00,アイコンを虫さんにしますね#新しいプロフィール画像 https://t.co/BJR0POUrSU,12,0,51,50,https://twitter.com/java_don_/status/1552990459785781248,12
1552989326862356483,mikecat_0302,2022-07-29 12:08:03+00:00,皆様にアドバイスをいただき、JAVA版の設定できました！本当にありがとうございました✨オプティファインでテストサーバーに入れたのに感動🥺たまたまお会いした方に、Shiftで挨拶できて、さらに感動🥺明日、ドズル社ランドで固まらないことを祈ってます😊さて、Switchでダイヤ掘ろうかな♪,40,0,403,409,https://twitter.com/mikecat_0302/status/1552989326862356483,40
1552968908675502081,tip1t,2022-07-29 10:46:55+00:00,最初にどのプログラミング言語を学ぶべきか？は、君がどうなりたいか/何をしたいか次第。■Webデザイナー・HTML/CSS・JavaScript■Webエンジニア・PHP or Java■PCツール・C#・Pythonなど■スマホアプリ・iPhone→Swift・Android→Kotlin#駆け出しエンジニアと繋がりたい続く↓↓,11,0,267,8,https://twitter.com/tip1t/status/1552968908675502081,11
1552966050450649088,0j56kvJ5i59Hrny,2022-07-29 10:35:33+00:00,今の会社にはJavaの案件が出来ると言われて入ったのですが、AccessVBA等の案件にアサインされています。SES、SIerの会社はどこも同じような感じだと思っているのですが、そうでも無い感じですか？ #駆け出しエンジニア  #駆け出しエンジニアと繋がりたい  #プログラミング初心者と繋がりたい,76,5,45,10,https://twitter.com/0j56kvJ5i59Hrny/status/1552966050450649088,81
1552965135475830784,ten_chanda,2022-07-29 10:31:55+00:00,【マイクラチャンネル一緒にやる人募集】・Premiere proの人(編集力があれば他ソフトでも可)・Javaを持ってる人・やる気がある人(撮影時間を守る。企画を考える。などなど)・二人三脚で頑張っていける人後から思いついた条件あればリプに書きます,23,3,800,215,https://twitter.com/ten_chanda/status/1552965135475830784,26
1552959262271279104,digital2022t,2022-07-29 10:08:35+00:00,今週もお疲れさまでした！！プログラミングコースでは、Javaの基礎を8日間かけて学習しました。来週からは実際に手を動かして実践力の習得を目指していきます🔥🔥来週もよろしくお願いいたします☺️#IT #転職 #第二新卒#駆け出しエンジニアと繋がりたい#新人エンジニア #プログラミング学習,30,1,264,1146,https://twitter.com/digital2022t/status/1552959262271279104,31
1552956465492570113,61natsu,2022-07-29 09:57:28+00:00,きたきた♪はじめてJavaでの参加♪楽しみだぁ！！仕事の休みもちょいちょい入れたし(^o^)次男からPCを奪って楽しむんだぁ！！#ドズル社ランド夏 https://t.co/xBUbCygJWq,14,0,495,322,https://twitter.com/61natsu/status/1552956465492570113,14
1552954341094735872,Htcx1_,2022-07-29 09:49:02+00:00,因みにPCマイクラ統合版しかない！ってそこの貴方。統合版持ってる人、JAVA版も無料でインスト出来るのでこれを機会に是非〜〜,12,0,652,98,https://twitter.com/Htcx1_/status/1552954341094735872,12
1552953888223154177,Htcx1_,2022-07-29 09:47:14+00:00,ちょっと前から呉川（@kurekawa311 ）と作るか〜〜って話しててようやっとマイクラ鯖（JAVA版）たてました。呉川か私と相互の方なら誰でも大歓迎なんで、遊びたいって人はここのリプか、直接DMか、呉川に直接連絡してくれれば🙏🏻 人が不快になることしなければ自由に遊んでくれて大丈夫です,19,0,652,98,https://twitter.com/Htcx1_/status/1552953888223154177,19
1552944044384612352,tomo_ka24,2022-07-29 09:08:07+00:00,javaの8月末終了が沢山です😭どうにか回遊したいので皆さまお助け下さい😭😭😭※LINE頂ければご紹介させて頂きます。 https://t.co/6q6cRm39sp,18,1,218,178,https://twitter.com/tomo_ka24/status/1552944044384612352,19
1552937836470484992,sas_ruu,2022-07-29 08:43:27+00:00,おきゅおわ𓂃 𓈒𓏸ご帰宅ありがとうございましたʚ❤︎ɞチェキブロもありがとう🥺💕javaティー初めて飲んだ！美味しかった🫖やっぱりゆっくりお話できるのっていいね₍ᐢ › ༝ ‹ ᐢ₎💭🍦次は8月2日 13〜18じ です🍦ご帰宅待ってます✊❤️‍🔥 https://t.co/GNfqQqlPdJ,30,1,308,46,https://twitter.com/sas_ruu/status/1552937836470484992,31
1553211745489264640,maco_mk7,2022-07-30 02:51:52+00:00,Twitterのアルゴリズムが変わって、リプしてないアカウントは伸びにくくなったと耳にしました👂昨夜はインスタ運用をされてる方々のお話を聞いたのですが、みなさん試行錯誤をされているのですね💡SNSは交流が目的だから、そちらに寄せていってる感じでしょうかね～🤔,22,0,137,106,https://twitter.com/maco_mk7/status/1553211745489264640,22
1553118114287853568,bookofbear,2022-07-29 20:39:48+00:00,おはようございます。昨日は機械学習のアルゴリズムの学習に没頭しすぎて疲れてしまいました。でもこれまでは、機械学習では便利なPythonライブラリに頼ってばかりだったので、自分で仕組みを作る、という経験をもっと積みたいものです。何より楽しいし。#朝活 #駆け出しエンジニアと繋がりたい,36,0,483,360,https://twitter.com/bookofbear/status/1553118114287853568,36
1553064887420866560,tobiuo77,2022-07-29 17:08:18+00:00,#おりあつきなひな 今回も楽しかった！しかし配信中に「ここ難しいから練習したい」ってステージが一切ソロの時来ないんだけど何で😭？参加者とかでステージ選択のアルゴリズム違うのかな。スライムクライムはもう少し練習すれば行けそう。スライムスクレイパーの方は…👺ファイナルに行きたい🫠 https://t.co/WASTbeQHTF,10,1,221,425,https://twitter.com/tobiuo77/status/1553064887420866560,11
1553033363576868864,oreo_writing,2022-07-29 15:03:02+00:00,／ おれおは🍪#おは戦40730jd＼今週もお疲れ様🥰今日も僕と絡みませんか🥰今日もここにリプしてみて。それからリプ欄全員に絡む。アルゴリズムに評価されればあなたの認知度は爆上がりだ。繋がって仲を深めていこうね。みんな最高の1日にしよう！置きリプ歓迎！『おはよ』だけでもOK🙆,38,4,683,349,https://twitter.com/oreo_writing/status/1553033363576868864,42
1553029335506100229,yesman_of_putin,2022-07-29 14:47:02+00:00,@T44624852 動画本編がエロかったら普通に規制されるのに広告と動画で判断アルゴリズムを変えてる理由がわからんのだなこれが,199,0,138,201,https://twitter.com/yesman_of_putin/status/1553029335506100229,199
1553006060889591808,1003Ci,2022-07-29 13:14:33+00:00,「私も○○なんだよね」その言葉を聞いて自分と同じ状況の人がいるそう分かった瞬間ホッとした私あー、これ機械的条件反射のパターンじゃん！とハッとした今日自分が凹むパターンとそこから復活するパターンこれ全部事実判断の中で反応するアルゴリズムふむ、ここから＃事実判断,10,0,349,680,https://twitter.com/1003Ci/status/1553006060889591808,10
1552991165242540033,koiwa_moment,2022-07-29 12:15:21+00:00,ノランちゃんドラッグ💊完成したって！でも、それは公言しない方が良いのでは💦ノラップ自動文字起こしバージョン２！ユーチューブのアルゴリズムさんがんばれ！#ユージェネライブ https://t.co/DMX4Et3Opp,11,0,197,191,https://twitter.com/koiwa_moment/status/1552991165242540033,11
1552959515661701121,kouyasan2020,2022-07-29 10:09:35+00:00,fpでDNGの撮影、現像テスト。今まで空の白飛びで悩んでましたが、14bitDNGで撮って、単純に現像ソフトでハイライト落とせば良かったんですね。LuminarAIとLuminarNEOだと、ハイライトの処理が後者の方がキレイに感じます。アルゴリズムが違うのでしょうか。#SIGMAfp #sigma65mm #LuminarNEO https://t.co/iw4m3YreaQ,42,2,398,366,https://twitter.com/kouyasan2020/status/1552959515661701121,44
1552948576543993857,BinomialSheep,2022-07-29 09:26:07+00:00,これが「半数以上のIT企業でアルゴリズム能力がカンストしている」ということ…… https://t.co/NENxbWXDTD,11,0,258,184,https://twitter.com/BinomialSheep/status/1552948576543993857,11
1552929243289747461,UlrrE68m9mtqY8F,2022-07-29 08:09:18+00:00,どういうこと？Googleのアルゴリズムは人類に何を伝えたいんや…… https://t.co/TFAWbqR9DV,33,7,174,462,https://twitter.com/UlrrE68m9mtqY8F/status/1552929243289747461,40
1552833095237132289,roro_puzdra,2022-07-29 01:47:14+00:00,おはようございます☀3垢同時に広告ガチャ限出た(º ﾛ º๑) w確変タイム？時間によってガチャ限出るアルゴリズム的な⁉︎サブサブ垢にいたってはガチャ限2体出ました〜( ￣▽￣) https://t.co/YlvuK62fl9,12,0,859,985,https://twitter.com/roro_puzdra/status/1552833095237132289,12
1553130748344950784,ShoTakaNet1,2022-07-29 21:30:00+00:00,泥棒が嫌がるのは防犯カメラと犬の鳴き声だそうで、「防犯カメラに反応があったら犬の鳴き声をスピーカーから流す」という警戒システムを作った人が、ソースコードを公開しています。システムはRaspberry Piとスピーカー、カメラで構成され、正面と裏口にセットします。https://t.co/ErVXnmCTKa,11,10,306,200,https://twitter.com/ShoTakaNet1/status/1553130748344950784,21
1553038002653319168,blanc_7711,2022-07-29 15:21:28+00:00,#今日の積み上げ メモ✅侍教材のHTML/CSSの復習昨日からCSS学習中。CSSを知ることで、ホームページのソースがなんとなく読めるようになってきた。時間ができるといろんなホームページのコードを打ってみたり♪#駆け出しエンジニア#駆け出しエンジニアと繋がりたい#侍エンジニア#侍テラコヤ,13,0,23,11,https://twitter.com/blanc_7711/status/1553038002653319168,13
1553035743726931970,himazin_bivar,2022-07-29 15:12:29+00:00,ノーコードで書いたデザインとjsをlaravelにソースファイル置けたら楽だなと思ったけどノーコードで書いてノーコードのままで良くないから意味なかった#駆け出しエンジニアと繋がりたい,13,0,217,77,https://twitter.com/himazin_bivar/status/1553035743726931970,13
1553003924298559489,june19312,2022-07-29 13:06:03+00:00,PAST本は私のバイブルで、著者であるkenkooooさんのことも大変に尊敬しているのだが、今日の精進中、kenkooooさんはソースコードに祈りを込めて仏像を建立することがあるという逸話に遭遇し、この人はやっぱスゲエ！超リスペクト！という気持ちを深めた…（ABC198D問題、はまやんさんの解説より） https://t.co/nio89oOUU1,22,2,197,143,https://twitter.com/june19312/status/1553003924298559489,24
1552940240167325697,82tech,2022-07-29 08:53:00+00:00,🔽 GitHub、新しくなった「GitHub Projects」の提供を開始https://t.co/KEeGZnfllC簡単な開発プロジェクトの管理であれば、GitHubで完結させられそうですね👨🏻‍💻✅チケット管理✅ソースコード管理✅ワークフロー管理一元管理✨#GitHub #プログラミング #駆け出しエンジニアと繋がりたい,17,0,421,34,https://twitter.com/82tech/status/1552940240167325697,17
1552841814214070273,a_ya_pg,2022-07-29 02:21:53+00:00,エラーもなく、ただ動かないのって、エラー祭りよりしんどい…。ソースコードを動的に挿入して動かしてるから、順に追うのもめんどい…。昔々、開発者ツールなんて存在しないIE6と格闘した古のエンジニアたちは、アラートやらログやらで地道に足跡をたどったものですが、やりますか…。,12,1,274,252,https://twitter.com/a_ya_pg/status/1552841814214070273,13
1552700828095578113,Picnicer,2022-07-28 17:01:39+00:00,@igz0 コードレビューの結果、・正規表現利用禁止・三項条件演算式利用禁止・LINQ利用禁止・クラス作成禁止・メソッドの作成禁止・好きな変数名は利用できず暗号みたいな共通の名前しか使えず・レビュー時にエディタ禁止(excelにソースを添付必須)これが一般的な日本のコードレビュー☺️,33,21,188,184,https://twitter.com/Picnicer/status/1552700828095578113,54
1552653329452666881,em_webcreative,2022-07-28 13:52:55+00:00,学習 31日目。✔️復習・ソースコード整理✔️ポートフォリオカスタマイズ昨日、総復習を終えたのですぐ次に進もうと思ですが、今回学んだことを使いまわせるように保存したり、ポートフォリオに入れたり、アウトプットの日に。というと聞こえがいいですがちょっと休息日です😁#web制作#デイトラ,13,0,38,15,https://twitter.com/em_webcreative/status/1552653329452666881,13
1552592892195409921,Siawaseearth,2022-07-28 09:52:45+00:00,選挙機械のソースコードを教えてください2022年5月の選挙のためにフィリピンでは、公開ソースコードレビューが許可されました。https://t.co/Usof6S2RBG,12,2,597,471,https://twitter.com/Siawaseearth/status/1552592892195409921,14
1552294446045499394,old_pgmrs_will,2022-07-27 14:06:50+00:00,オリジナル音楽アプリが作れる「Origify」のiOS用コードのオープンソース化。事業撤退ということで諸事情あるようです。ともあれiOSアプリ開発に興味のある駆け出し勢には、ドチャクソありがたいコードサンプルになるはず。要チェックです。#駆け出しエンジニアと繋がりたい https://t.co/A4fHPFPvJA,26,1,517,512,https://twitter.com/old_pgmrs_will/status/1552294446045499394,27
1552215694636331010,maruchan_73,2022-07-27 08:53:55+00:00,明細書の修正って、ソフトウエアのソースコードの手直しと同じで、一箇所いじったら他にも波及することあるから改めて全体の整合性を考え直すことも必要になったりする。なので、明細書の作成に際し、できるだけモジュール分割して多少修正されてもスパゲッティコードにならないようにと心がける。,26,2,696,592,https://twitter.com/maruchan_73/status/1552215694636331010,28
1552184233237843968,nao_consulting,2022-07-27 06:48:54+00:00,エンジニアチャンネルさんがYouTubeの企画でやってた『英文を自動翻訳するプログラム』を実際に作ってみました！言語：Python開発手順から完成したソースコードまで全て載せてますので、興味のある方は是非ご覧ください。https://t.co/FoW4wxGAtp#note #ブログ #ブログ初心者 #ブログ仲間募集中,14,0,485,393,https://twitter.com/nao_consulting/status/1552184233237843968,14
1552084973535997953,Naoko705310,2022-07-27 00:14:28+00:00,学習106日目 (2h)✳️Codestep Company Site レスポンシブ自分で書いたコードの修正を一旦諦めて、ソースコード丸写ししたのに、まさかの表示崩れ💀💀💀なんで？？？とりあえず置いといて、jQueryを先に進める。#プログラミング独学#Codestep,23,0,321,270,https://twitter.com/Naoko705310/status/1552084973535997953,23
1551940595199127552,vTz4E20oLLV1Mp7,2022-07-26 14:40:46+00:00,今日の勉強時間　4時間30分勉強内容ブラックジャックゲームのコーディングターミナルで起動するまでは完成したのでソースコードをgithubにアップロードしました。https://t.co/76ytOSjywP＃駆け出しエンジニアと繋がりたい,14,0,27,24,https://twitter.com/vTz4E20oLLV1Mp7/status/1551940595199127552,14
1551940430484623366,mkdir_777,2022-07-26 14:40:06+00:00,wordpress勉強中もうちょい一冊目おわりまっせ！キンドル本めっちゃ安いそして、この教本めっちゃわかりやすかった。✅本読む✅リファレンス見る✅コード書く✅画面見る✅ソース見るを気づかせてくれる良本でした1300円なら買いっすね#今日の積み上げ#駆け出しエンジニアと繋がりたい https://t.co/k75hRy16O2,22,0,448,303,https://twitter.com/mkdir_777/status/1551940430484623366,22
1551936331928190976,taroro_tarotaro,2022-07-26 14:23:49+00:00,公開するってことで・Twitter APIを使ったユーザー検索・過去に検索したユーザーの履歴の保存を追加で作りました！起動する時のショートカットは以下で設定できます（デフォ値入れるの忘れた笑）chrome://extensions/shortcutsソースコードはここで公開してます。https://t.co/snopercOnD,10,1,597,530,https://twitter.com/taroro_tarotaro/status/1551936331928190976,11
1551930964997439488,tomo555777,2022-07-26 14:02:30+00:00,■模写コーティング■参考サイト：Codestepフッターがサイトの下に収まらないで、サイトの中間当たりきて検索してもわからず、ソースコードを上からゆっくりみたら、mainにheightを付けていたのはずしたら直った。#プログラミング初心者と繋がりたい #駆け出しエンジニアと繋がりたい#Web制作 https://t.co/kUUQjaVCNi,19,0,581,707,https://twitter.com/tomo555777/status/1551930964997439488,19
1551925116631937024,toyosaku_s,2022-07-26 13:39:15+00:00,unix入門復旧したはいいけど、入力したソースコード全部消えてて泣いてる、、、,10,0,153,151,https://twitter.com/toyosaku_s/status/1551925116631937024,10
1551894685207396352,TasogarKamen,2022-07-26 11:38:20+00:00,艦これ界隈って毎年何かやらかしてね？SMBCソースコード流出もそうだったけど信者のヤベー奴が多すぎるわ。アズレンやってる時に艦これ信者がアズレンが鈴鹿サーキットとコラボするって噂に対して「鈴鹿サーキットでございます。」とか意味の分からんメール自作してデマ流してたの見たし。 https://t.co/ScpqzpYcuY,11,6,159,198,https://twitter.com/TasogarKamen/status/1551894685207396352,17
1551830663762161664,free__age,2022-07-26 07:23:56+00:00,昔の自分のソースコードいじるの本当に恥ずかしいし、ページ数多めのサイト作るの慣れてなさすぎてCSSのページ分けがむちゃくちゃ自由で若さを感じる（最大限にポジティブな表現）,17,0,309,360,https://twitter.com/free__age/status/1551830663762161664,17
1553228790469652482,bebebensan,2022-07-30 03:59:35+00:00,おはようございます！7月目標:AWS StepFunctions / Lambda / Pythonを連動させた仕組みと制御の理解タスク・vue.js2の使用方法の調査+動作確認（業務で必要なため） #プログラミング #プログラミング学習  #エンジニア #エンジニア初心者 #駆け出しエンジニアと繋がりたい #今日の積み上げ,12,0,436,923,https://twitter.com/bebebensan/status/1553228790469652482,12
1553191334177288192,ntomomomomo,2022-07-30 01:30:45+00:00,最近暫くGCPだったけど、久々のAWSマネジメントコンソール…なんだろうこの安心感…,27,1,129,292,https://twitter.com/ntomomomomo/status/1553191334177288192,28
1553186633880457216,0614d_suke,2022-07-30 01:12:04+00:00,おはようございます！☀️ #今日の積み上げ･JavaScript･ブログ･メンター今日はナン食べに行きたいな🍛 #駆け出しエンジニアと繋がりたい #Webエンジニア #AWS  #JavaScript  #Vue,16,2,383,177,https://twitter.com/0614d_suke/status/1553186633880457216,18
1553141118275297280,ATSUOSHOCK,2022-07-29 22:11:13+00:00,おはようございます☀今週末は天気も良く夏晴れですね、こんな時は朝日を浴びながら朝勉していきましょう！さぁ今日も積み上げよう！▷AWS-SCS勉強▷筋トレ▷動画編集▷読書#今日の積み上げ#朝活 #勉強 #会社員 https://t.co/raV2g0E5FK,13,0,74,57,https://twitter.com/ATSUOSHOCK/status/1553141118275297280,13
1553140844219494401,aws_TakS07,2022-07-29 22:10:07+00:00,おはようございます☀️AWSエンジニアが個人で毎月使うAWSコストってどのくらいが普通なんでしょうかね。僕は最近だと3000〜4000円くらいです。今月はちょっと高い… https://t.co/Q6exe3aiA9,15,0,893,286,https://twitter.com/aws_TakS07/status/1553140844219494401,15
1553122878899400704,mezase_Engineer,2022-07-29 20:58:44+00:00,おはようございます。（朝活通算377日）調べても調べても沼にハマるー。めげずにやってこう。今日明日で終わらせたいー。AWS難しい。今日やること・ポートフォリオ本日も頑張りましょう！#朝活,14,0,236,253,https://twitter.com/mezase_Engineer/status/1553122878899400704,14
1553103391898869762,yastinbieber6,2022-07-29 19:41:18+00:00,少し前まで、herokuなんてアプリ開発する上で必要ないやろ！なんて思ってたけど、AWSを学んで苦労してEC2経由でデプロイ成功させてから、herokuの素晴らしさを痛感するようになった。heroku最高!笑#今日の積み上げ #駆け出しエンジニアと繋がりたい,19,0,192,24,https://twitter.com/yastinbieber6/status/1553103391898869762,19
1553029098074963971,macintoshi1,2022-07-29 14:46:05+00:00,やば過ぎてさべえ#AWS#駆け出しエンジニアと繋がりたい#AWSDeveloperAssociate,11,0,104,387,https://twitter.com/macintoshi1/status/1553029098074963971,11
1553017243344474113,LEfizadu3KQLUwM,2022-07-29 13:58:59+00:00,@aws_official 今日はさすがのチーターちゃんも少し暑そうですね🥵お腹がドッドッ...って動き早いからやはりチーターさんも暑いものは暑いですよね😣こどもなら尚更体温高くなるし...しっかりと水分補給してね🥤☺️,10,0,41,41,https://twitter.com/LEfizadu3KQLUwM/status/1553017243344474113,10
1552963786126282752,SatoshiMuraka16,2022-07-29 10:26:33+00:00,#vana1429日の結果報告- SAP on AWS - Specialty 試験合格しました！🎉これで、また AWS 全資格保有者になりました。まだまだ実力不足なので、コツコツやっていきます🐢vana 課題も一つクリアできたし、今晩から🍺解禁です！😄,41,1,197,167,https://twitter.com/SatoshiMuraka16/status/1552963786126282752,42
1552956143374577669,Saaaatooowitter,2022-07-29 09:56:11+00:00,🟩day31🟢mySQLレクチャーで使ったpostgres以外触ったの初めてだったけどcaseもspaceもsensitiveじゃないのめちゃつかいやすかった笑ビビりながらdocker触ってたけど多分こっちは大丈夫…AWSはまだ怖い😂#100DaysOfCode,11,3,35,48,https://twitter.com/Saaaatooowitter/status/1552956143374577669,14
1552946388039675905,kyooooonaka,2022-07-29 09:17:25+00:00,今日も一日お疲れ様でした。一旦AWS-SCSを受験するのは、後にしてハンズオン中心に勉強します。無料枠があるうちに、CloudWatchのカスタムメトリクス取得のLambda実装は出来るようになっておきたいな。#AWS #AWS認定 #エンジニアと繋がりたい #駆け出しエンジニアと繋がりたい,19,0,203,263,https://twitter.com/kyooooonaka/status/1552946388039675905,19
1552940080284569601,hayanohako,2022-07-29 08:52:22+00:00,@aws_official 毎日のツイートで動画を見せていただいていますが、急におっきくなったと感じたのは自分だけではないはず🤣,13,0,18,17,https://twitter.com/hayanohako/status/1552940080284569601,13
1552924950138605569,mipon_zzz,2022-07-29 07:52:14+00:00,AWSの試験受かった😮‍💨「スキルアップの勉強してる？」って上司にいつも聞かれる半期面談が来週に迫る中、ギリギリの取得。来週までに更に取れる資格探そ😮‍💨,11,0,213,199,https://twitter.com/mipon_zzz/status/1552924950138605569,11
1552918627548266496,damm_shit_,2022-07-29 07:27:07+00:00,GirlのMOUSE、AWSのphotosynthesisとか他多数のVHSが未だに手元にあるからDVDに焼いて保存せなテープにカビ生えそう,11,0,819,911,https://twitter.com/damm_shit_/status/1552918627548266496,11
1552896564414521344,E_Anzbell0723,2022-07-29 05:59:27+00:00,AWS認定クラウドプラクティショナー試験を受けましたので結果をお伝えします。結果： I did it!!!! 合格です！！！模擬試験2回やったところ、70%で合格のところ、52%と67%しか取れなかったので心配してましたが、無事合格出来ました！！！これで9月から働く会社の入社条件クリアです(*-`ω´-)９,18,0,481,1229,https://twitter.com/E_Anzbell0723/status/1552896564414521344,18
1553186939016462336,sBu5JmF34Xhe2aM,2022-07-30 01:13:17+00:00,#今日の目標勉強する　Gitにて構成・コードを少しでも見たい#医療事務 #python #駆け出しエンジニアと繋がりたい#プログラミング初心者と繋がりたい #coding #programming #pythonlearning,15,3,53,24,https://twitter.com/sBu5JmF34Xhe2aM/status/1553186939016462336,18
1553167891792482304,creater_kitsune,2022-07-29 23:57:36+00:00,おはようございます！本日も案件対応頑張ります！#今日の積み上げ　✅Shopify 案件対応✅LP アニメーション提案 案件対応✅読書 Git入門　#駆け出しエンジニアと繋がりたい #Shopify,16,0,203,155,https://twitter.com/creater_kitsune/status/1553167891792482304,16
1553056670544449536,momochanjazz,2022-07-29 16:35:39+00:00,gitについて全然理解してないから、ちゃんと理解したい🥲今日、初めて「git コンフリクト」について学んだ(まだ理解が浅い……),14,0,650,541,https://twitter.com/momochanjazz/status/1553056670544449536,14
1553052856751882240,kemicch,2022-07-29 16:20:30+00:00,day29: 1h40mtotal: 136h20m環境構築Gitまとめ、初の技術面談あと懇親会！今月は同期34期生マシマシですごく楽しかったです😊その他先輩型も真面目な話から面白い話までありがとうございました！連日引越し等で学習時間取れない日が続きますが、焦らずコツコツ進めて行きます。,11,0,167,155,https://twitter.com/kemicch/status/1553052856751882240,11
1553032374438735873,vTz4E20oLLV1Mp7,2022-07-29 14:59:06+00:00,今日の勉強時間　3時間勉強内容gitの基本操作＃駆け出しエンジニアと繋がりたい,19,0,27,24,https://twitter.com/vTz4E20oLLV1Mp7/status/1553032374438735873,19
1552972205218095105,nanato_ENG,2022-07-29 11:00:01+00:00,gitのコミットメッセージ１行目：変更内容の要約２行目：空行３行目：変更した理由１行目を英語で書いてますが変な英語で謎なメッセージがよくできあがります😂書き方のルールを決めているとコミットの際に悩まなくてよいですね#駆け出しエンジニアと繋がりたい #プログラミング初心者,16,0,75,37,https://twitter.com/nanato_ENG/status/1552972205218095105,16
1552970183756902400,robo_7seg,2022-07-29 10:51:59+00:00,(たぶん)2000円で作れる電流制御モタドラのgitでのpublic公開ですが、ついでに基板単体も売るかという気持ちにより、院試数学後か、院試完全終了後に公開しようと思います。興味のある電子工作erなどは楽しみにしといておくら。,29,2,835,263,https://twitter.com/robo_7seg/status/1552970183756902400,31
1552965683184558082,karintozuki,2022-07-29 10:34:06+00:00,Gitで以下のコマンドを打つとそのレポジトリで今まで編集したコードの行数が見られます。まあ、生産性を測るのに行数を使うのはナンセンスですが、ちょっとした達成感を得るのにいかがでしょうか#プログラミング #駆け出しエンジニアと繋がりたい #Git #PHPer https://t.co/P46oYVUZjG,11,1,193,284,https://twitter.com/karintozuki/status/1552965683184558082,12
1552942009291157504,suzuki_py,2022-07-29 09:00:01+00:00,Qiitaで #Git に関する投稿を定期的に漁ってます！#プログラミング#プログラミング初心者#駆け出しエンジニアと繋がりたい.gitignoreでフォルダの構造のみを保持したい場合のより良い書き方https://t.co/syKBHvZ0pu,20,2,487,311,https://twitter.com/suzuki_py/status/1552942009291157504,22
1552924660513132545,tducomputer,2022-07-29 07:51:05+00:00,本日はゲーム班2年生主催によるGit講習会！上級生が下級生に教えていくのがコン部ゲーム班なのです！色々トラブルありながらもなんとか切り抜けました…お疲れ様〜✨ https://t.co/zwXYUVqRzl,21,3,385,301,https://twitter.com/tducomputer/status/1552924660513132545,24
1552918797681430529,Ri2Ritsu,2022-07-29 07:27:47+00:00,Gitのプロみたいな人いるから分かんないところ秒で解決できてすごい😳1聞くと10教えてくれるの天才すぎる😳,11,0,423,313,https://twitter.com/Ri2Ritsu/status/1552918797681430529,11
1552875149799862272,itomiki_hiyoko,2022-07-29 04:34:21+00:00,「Git 学習レッスン I」レッスンを修了しました！ https://t.co/f2Z4VZD5MG #Progate こうやって共同作業するのかーー。,13,0,76,80,https://twitter.com/itomiki_hiyoko/status/1552875149799862272,13
1552875032803610624,shimachangggg,2022-07-29 04:33:53+00:00,gitでファイル名を変えた際に変更が反映されない時があります。そんな時はgit mvでファイル名を変えてあげると検知されます👍#今日の積み上げ#プログラミング初心者,16,0,157,94,https://twitter.com/shimachangggg/status/1552875032803610624,16
1552872445362962432,rikako_hira,2022-07-29 04:23:36+00:00,herokuでデプロイ💡× Githerokuを使ったRailsアプリケーションのデプロイについて、学んだことをざっとまとめました💡Gitで管理しているリポジトリをHerokuへ反映する方法です。#駆け出しエンジニアと繋がりたい #heroku https://t.co/Zy2fBZZRNy,20,0,93,21,https://twitter.com/rikako_hira/status/1552872445362962432,20
1552859322832818176,HackerMaskee,2022-07-29 03:31:27+00:00,git も subversion も、バージョン管理ツールを使わないことと比較したら五十歩百歩、というかほぼ誤差。本当のやばいのは「提案書_最終版(2)-レビュー前修正0729_指摘事項反映.xlsx」みたいなやつ https://t.co/ORQGrnMSSf,42,20,275,412,https://twitter.com/HackerMaskee/status/1552859322832818176,62
1552809552931946496,yuuu1654,2022-07-29 00:13:41+00:00,Git理解していないと本当に詰みます。実際の仕事でもそうだと思いますが、Git理解していないと作業が進まないし、本来集中するべきところに全く集中できないので、これから勉強をされる方はGit(conflictやAutomatic merge)辺りは理解しておいた方がいいです。#駆け出しエンジニアと繋がりたい,23,0,270,29,https://twitter.com/yuuu1654/status/1552809552931946496,23
1552793959876833280,creater_kitsune,2022-07-28 23:11:44+00:00,おはようございます！本日も案件対応頑張ります！#今日の積み上げ　✅Shopify 案件対応✅LP アニメーション提案 案件対応✅読書 Git入門　#駆け出しエンジニアと繋がりたい #Shopify,28,2,203,155,https://twitter.com/creater_kitsune/status/1552793959876833280,30
1552785790383824896,gigagent,2022-07-28 22:39:16+00:00,Git&amp;GitHub履修開始！いちばんやさしいと書いてあるが図解の多い本書でも横文字の専門用語は出てくる。途中で挫折する人ってそういったところで折れるのでは？#駆け出しエンジニアと繋がりたい #エンジニアと繋がりたい #独学 #プログラミング初心者と繋がりたい #朝活 #読書 https://t.co/O5R3ZBGIcq,14,1,66,154,https://twitter.com/gigagent/status/1552785790383824896,15
1552726798927966208,kimu_tg,2022-07-28 18:44:51+00:00,gitのpushに時間がかかる時はいっぱいコード書いたんだなっていうなんか仕事たくさんした気になる。実際は画像ファイルが多いだけなんだけども。,10,0,974,188,https://twitter.com/kimu_tg/status/1552726798927966208,10
1552692538083246081,Ruth_Lessismore,2022-07-28 16:28:43+00:00,2022.7.29.Fri.🌙1:00 #朝活 開始・案件対応・Git入門の本を読む 　娘はおばあちゃんちにお泊まり。いとこ大集合で楽しんでるみたい☺️　私は夕飯の後、ソファで洗濯物を畳みながら寝落ち😪💤よく寝た〜〜✨✨　今日は平日フリーランスデー！！！タスクやり切る🔥#codolife #Web制作,18,0,365,329,https://twitter.com/Ruth_Lessismore/status/1552692538083246081,18
1552690425634648064,bassa_IT,2022-07-28 16:20:19+00:00,Day21.7月28日【勉強時間】3.5H【やったこと】コマンドラインとgit・JS入門【今日のCREAD】残業も1.5Hしたけどしっかり勉強できたからGeekOut😙【明日目標】JSできる限り進める😴―――――――――――――――――合計:84.0H/1000H#1000時間チャレンジ,12,0,89,163,https://twitter.com/bassa_IT/status/1552690425634648064,12
1552683457545121793,kou08web,2022-07-28 15:52:38+00:00,本日の学習アウトプットSourceTreeについて＞Gitをマウス操作するためのモノ＞Windowsと Mac両方対応可→Git＝ファイルの状態を更新履歴として保存することができ、過去の状態にしたり、編集箇所の差を表示することも可＃駆け出しエンジニア＃駆け出しエンジニアと繋がりたい,13,0,28,13,https://twitter.com/kou08web/status/1552683457545121793,13
1552671842632343552,vTz4E20oLLV1Mp7,2022-07-28 15:06:29+00:00,今日の勉強時間　4時間勉強内容Linuxの基本操作gitの基本操作応用情報技術者R3春期午後試験＃駆け出しエンジニアと繋がりたい,13,0,27,24,https://twitter.com/vTz4E20oLLV1Mp7/status/1552671842632343552,13
1552637450757226497,kemicch,2022-07-28 12:49:49+00:00,day28 :4.5htotal: 134h40m環境構築Git操作続き、さっさと終わらせようと思ったらpushでエラーが起きて進まなかったりと変な苦戦😂引越し荷詰めの傍らでPF進捗会も聞かせて頂き色々参考になりました、発表者の皆さんありがとうございました‼️ ✨,12,0,167,155,https://twitter.com/kemicch/status/1552637450757226497,12
1552624526043004928,suica_diary,2022-07-28 11:58:28+00:00,【駆け出しの頃にやってた最終手段】Gitで競合起きて上手く解消出来ずによくわかんなくなった時。「(自分のローカルリポジトリを)バルス！」#プログラミング#エンジニア#駆け出しエンジニアと繋がりたい https://t.co/VmkU4tBiq4,21,0,284,263,https://twitter.com/suica_diary/status/1552624526043004928,21
1552613463750455296,a2wxwe,2022-07-28 11:14:30+00:00,@Nonato_Note GUIで覚える若葉ちゃんの本最高でしたよ。https://t.co/8xt6DgJjff,18,1,71,48,https://twitter.com/a2wxwe/status/1552613463750455296,19
